,id,stage,season,date,home_team,away_team,goal_home_team,goal_away_team,B365H,B365D,B365A,on_target_shot_home_team,on_target_shot_away_team,off_target_shot_home_team,off_target_shot_away_team,foul_home_team,foul_away_team,yellow_card_home_team,yellow_card_away_team,red_card_home_team,red_card_away_team,crosses_home_team,crosses_away_team,corner_home_team,corner_away_team,possession_home_team,possession_away_team,goal,on_target_shot,off_target_shot,foul,yellow_card,red_card,crosses,corner
0,1730,1,2008/2009,2008-08-16 00:00:00,Arsenal,West Bromwich Albion,1,0,1.2,6.5,15.0,12,2,13,3,11,9,0,0,0,0,21,7,7,5,66.0,34.0,1,14,16,20,0,0,28,12
1,1731,1,2008/2009,2008-08-16 00:00:00,Sunderland,Liverpool,0,1,5.5,3.6,1.67,4,11,3,5,13,12,0,2,0,0,15,19,1,8,46.0,54.0,1,15,8,25,2,0,34,9
2,1732,1,2008/2009,2008-08-16 00:00:00,West Ham United,Wigan Athletic,2,1,1.91,3.4,4.2,5,7,7,15,14,13,2,1,0,0,15,27,6,10,52.0,48.0,3,12,22,27,3,0,42,16
3,1734,1,2008/2009,2008-08-16 00:00:00,Everton,Blackburn Rovers,2,3,2.0,3.3,4.0,2,8,7,8,11,11,2,2,0,0,14,21,3,4,51.0,49.0,5,10,15,22,4,0,35,7
4,1735,1,2008/2009,2008-08-16 00:00:00,Middlesbrough,Tottenham Hotspur,2,1,3.2,3.4,2.25,7,2,5,5,11,11,1,2,0,0,25,27,7,9,53.0,47.0,3,9,10,22,3,0,52,16
5,1736,1,2008/2009,2008-08-16 00:00:00,Bolton Wanderers,Stoke City,3,1,1.83,3.5,4.5,5,1,7,6,14,15,1,2,0,0,22,29,4,3,47.0,53.0,4,6,13,29,3,0,51,7
6,1737,1,2008/2009,2008-08-16 00:00:00,Hull City,Fulham,2,1,2.6,3.2,2.8,5,4,5,6,10,9,3,0,0,0,16,14,5,6,53.0,47.0,3,9,11,19,3,0,30,11
7,1729,1,2008/2009,2008-08-17 00:00:00,Manchester United,Newcastle United,1,1,1.29,5.5,11.0,11,1,10,9,16,11,3,0,0,0,24,9,6,6,55.0,45.0,2,12,19,27,3,0,33,12
8,1733,1,2008/2009,2008-08-17 00:00:00,Aston Villa,Manchester City,4,2,1.91,3.4,4.33,5,9,4,5,11,13,0,1,0,0,16,16,7,8,52.0,48.0,6,14,9,24,1,0,32,15
9,1738,1,2008/2009,2008-08-17 00:00:00,Chelsea,Portsmouth,4,0,1.33,5.0,10.0,6,7,10,5,11,8,0,1,0,0,25,9,8,3,65.0,35.0,4,13,15,19,1,0,34,11
10,1839,2,2008/2009,2008-08-23 00:00:00,Liverpool,Middlesbrough,2,1,1.36,4.5,10.0,6,4,13,5,9,12,2,1,0,0,21,13,13,3,57.0,43.0,3,10,18,21,3,0,34,16
11,1840,2,2008/2009,2008-08-23 00:00:00,Tottenham Hotspur,Sunderland,1,2,1.5,4.0,7.0,6,4,8,4,10,14,1,2,0,0,42,22,12,6,55.0,45.0,3,10,12,24,3,0,64,18
12,1841,2,2008/2009,2008-08-23 00:00:00,Newcastle United,Bolton Wanderers,1,0,1.8,3.5,4.75,6,3,3,8,11,9,1,2,0,0,15,22,4,5,57.0,43.0,1,9,11,20,3,0,37,9
13,1843,2,2008/2009,2008-08-23 00:00:00,Blackburn Rovers,Hull City,1,1,1.57,3.75,7.0,4,3,6,2,11,16,0,1,0,0,20,10,6,3,60.0,40.0,2,7,8,27,1,0,30,9
14,1844,2,2008/2009,2008-08-23 00:00:00,Fulham,Arsenal,1,0,6.5,3.75,1.57,2,8,3,11,15,6,2,0,0,0,10,24,1,5,47.0,53.0,1,10,14,21,2,0,34,6
15,1845,2,2008/2009,2008-08-23 00:00:00,West Bromwich Albion,Everton,1,2,2.88,3.25,2.5,7,4,11,4,12,15,3,1,0,0,27,6,11,5,47.0,53.0,3,11,15,27,4,0,33,16
16,1847,2,2008/2009,2008-08-23 00:00:00,Stoke City,Aston Villa,3,2,5.0,3.6,1.73,1,0,6,3,15,5,1,0,0,0,20,15,2,8,46.0,54.0,5,1,9,20,1,0,35,10
17,1842,2,2008/2009,2008-08-24 00:00:00,Manchester City,West Ham United,3,0,2.3,3.25,3.2,5,0,6,2,13,14,0,2,0,0,16,7,6,3,58.0,42.0,3,5,8,27,2,0,23,9
18,1848,2,2008/2009,2008-08-24 00:00:00,Wigan Athletic,Chelsea,0,1,8.5,4.5,1.4,9,4,2,3,14,16,1,2,0,0,20,10,7,7,50.0,50.0,1,13,5,30,3,0,30,14
19,1846,2,2008/2009,2008-08-25 00:00:00,Portsmouth,Manchester United,0,1,4.8,3.4,1.8,4,7,8,5,11,13,2,2,0,0,17,13,4,3,36.0,64.0,1,11,13,24,4,0,30,7
20,1950,3,2008/2009,2008-08-30 00:00:00,Arsenal,Newcastle United,3,0,1.44,4.0,9.0,12,1,7,3,13,12,2,2,0,0,19,9,11,1,53.0,47.0,3,13,10,25,4,0,28,12
21,1952,3,2008/2009,2008-08-30 00:00:00,West Ham United,Blackburn Rovers,4,1,2.5,3.25,2.88,4,7,3,5,12,20,1,5,0,0,24,20,10,4,55.0,45.0,5,11,8,32,6,0,44,14
22,1954,3,2008/2009,2008-08-30 00:00:00,Everton,Portsmouth,0,3,2.1,3.3,3.75,7,2,10,2,4,13,1,0,0,0,24,9,5,3,59.0,41.0,3,9,12,17,1,0,33,8
23,1955,3,2008/2009,2008-08-30 00:00:00,Middlesbrough,Stoke City,2,1,1.57,3.6,7.0,4,1,10,5,13,17,2,4,0,1,19,11,4,4,47.0,53.0,3,5,15,30,6,1,30,8
24,1956,3,2008/2009,2008-08-30 00:00:00,Bolton Wanderers,West Bromwich Albion,0,0,1.83,3.5,4.5,10,7,9,7,21,18,2,2,0,0,26,10,7,5,52.0,48.0,0,17,16,39,4,0,36,12
25,1957,3,2008/2009,2008-08-30 00:00:00,Hull City,Wigan Athletic,0,5,2.5,3.25,2.88,4,1,7,4,20,13,1,0,0,0,23,12,7,4,48.0,52.0,5,5,11,33,1,0,35,11
26,1951,3,2008/2009,2008-08-31 00:00:00,Sunderland,Manchester City,0,3,2.2,3.3,3.4,4,6,7,1,20,12,4,2,0,0,15,11,3,3,46.0,54.0,3,10,8,32,6,0,26,6
27,1953,3,2008/2009,2008-08-31 00:00:00,Aston Villa,Liverpool,0,0,3.0,3.25,2.4,2,5,5,7,8,12,0,2,0,0,20,22,5,8,45.0,55.0,0,7,12,20,2,0,42,13
28,1958,3,2008/2009,2008-08-31 00:00:00,Chelsea,Tottenham Hotspur,1,1,1.4,4.33,9.0,5,1,10,4,10,14,3,0,0,0,17,18,5,8,50.0,50.0,2,6,14,24,3,0,35,13
29,2049,4,2008/2009,2008-09-13 00:00:00,Liverpool,Manchester United,2,1,3.0,3.0,2.6,10,4,6,3,10,16,0,3,0,0,23,14,5,4,56.0,44.0,3,14,9,26,3,0,37,9
30,2051,4,2008/2009,2008-09-13 00:00:00,Newcastle United,Hull City,1,2,1.62,3.75,5.75,3,3,10,5,10,17,0,2,1,0,15,13,5,3,51.0,49.0,3,6,15,27,2,1,28,8
31,2052,4,2008/2009,2008-09-13 00:00:00,Manchester City,Chelsea,1,3,4.33,3.3,1.91,3,5,10,9,15,12,0,1,0,1,15,18,8,5,48.0,52.0,4,8,19,27,1,1,33,13
32,2053,4,2008/2009,2008-09-13 00:00:00,Blackburn Rovers,Arsenal,0,4,4.5,3.5,1.83,3,5,7,8,10,8,1,1,0,0,18,15,5,5,,,4,8,15,18,2,0,33,10
33,2054,4,2008/2009,2008-09-13 00:00:00,Fulham,Bolton Wanderers,2,1,2.25,3.3,3.3,11,5,7,4,17,12,1,1,0,0,31,17,12,6,64.0,36.0,3,16,11,29,2,0,48,18
34,2055,4,2008/2009,2008-09-13 00:00:00,West Bromwich Albion,West Ham United,3,2,2.4,3.25,3.0,5,12,6,6,10,20,1,1,0,0,19,15,8,8,57.0,43.0,5,17,12,30,2,0,34,16
35,2056,4,2008/2009,2008-09-13 00:00:00,Portsmouth,Middlesbrough,2,1,2.0,3.5,3.75,12,1,10,6,8,5,2,1,0,0,30,8,3,2,,,3,13,16,13,3,0,38,5
36,2058,4,2008/2009,2008-09-13 00:00:00,Wigan Athletic,Sunderland,1,1,2.05,3.3,4.0,9,3,9,3,10,8,1,1,0,0,36,13,8,6,54.0,46.0,2,12,12,18,2,0,49,14
37,2057,4,2008/2009,2008-09-14 00:00:00,Stoke City,Everton,2,3,3.4,3.4,2.2,5,3,5,3,8,16,2,1,0,0,22,20,6,8,61.0,39.0,5,8,8,24,3,0,42,14
38,2050,4,2008/2009,2008-09-15 00:00:00,Tottenham Hotspur,Aston Villa,1,2,2.1,3.3,3.6,14,9,8,6,17,12,1,4,0,0,34,16,12,8,54.0,46.0,3,23,14,29,5,0,50,20
39,2059,5,2008/2009,2008-09-20 00:00:00,Liverpool,Stoke City,0,0,1.2,6.5,15.0,13,2,15,2,8,12,1,1,0,0,61,11,20,3,64.0,36.0,0,15,17,20,2,0,72,23
40,2060,5,2008/2009,2008-09-20 00:00:00,Sunderland,Middlesbrough,2,0,2.38,3.1,3.2,11,12,6,4,11,15,2,3,0,0,23,19,8,5,51.0,49.0,2,23,10,26,5,0,42,13
41,2062,5,2008/2009,2008-09-20 00:00:00,West Ham United,Newcastle United,3,1,2.1,3.3,3.6,4,9,9,4,9,18,1,2,0,0,14,27,2,6,59.0,41.0,4,13,13,27,3,0,41,8
42,2064,5,2008/2009,2008-09-20 00:00:00,Blackburn Rovers,Fulham,1,0,2.1,3.3,3.6,2,5,8,6,13,12,2,0,0,0,21,19,4,3,47.0,53.0,1,7,14,25,2,0,40,7
43,2065,5,2008/2009,2008-09-20 00:00:00,Bolton Wanderers,Arsenal,1,3,6.5,3.75,1.57,7,5,5,12,15,10,2,2,0,0,29,33,7,17,43.0,57.0,4,12,17,25,4,0,62,24
44,2061,5,2008/2009,2008-09-21 00:00:00,Tottenham Hotspur,Wigan Athletic,0,0,1.73,3.6,5.0,7,5,6,9,17,12,2,2,0,0,17,18,3,4,45.0,55.0,0,12,15,29,4,0,35,7
45,2063,5,2008/2009,2008-09-21 00:00:00,Manchester City,Portsmouth,6,0,2.0,3.3,4.0,5,2,4,8,13,15,0,1,0,0,23,13,8,5,59.0,41.0,6,7,12,28,1,0,36,13
46,2066,5,2008/2009,2008-09-21 00:00:00,West Bromwich Albion,Aston Villa,1,2,3.25,3.3,2.25,7,4,5,7,21,15,3,3,0,0,26,13,5,6,49.0,51.0,3,11,12,36,6,0,39,11
47,2067,5,2008/2009,2008-09-21 00:00:00,Hull City,Everton,2,2,3.1,3.4,2.3,4,7,5,8,12,12,0,1,0,0,12,19,4,6,46.0,54.0,4,11,13,24,1,0,31,10
48,2068,5,2008/2009,2008-09-21 00:00:00,Chelsea,Manchester United,1,1,2.2,3.1,3.6,16,8,9,6,16,23,1,7,0,0,32,13,7,4,50.0,50.0,2,24,15,39,8,0,45,11
49,2069,6,2008/2009,2008-09-27 00:00:00,Manchester United,Bolton Wanderers,2,0,1.22,6.0,15.0,19,5,11,5,9,10,0,3,0,0,30,14,16,4,79.0,21.0,2,24,16,19,3,0,44,20
50,2070,6,2008/2009,2008-09-27 00:00:00,Arsenal,Hull City,1,2,1.2,6.0,17.0,12,3,11,3,9,13,2,1,0,0,27,9,15,4,62.0,38.0,3,15,14,22,3,0,36,19
51,2071,6,2008/2009,2008-09-27 00:00:00,Aston Villa,Sunderland,2,1,1.57,3.75,6.5,7,2,4,6,8,9,1,1,0,0,15,21,5,5,53.0,47.0,3,9,10,17,2,0,36,10
52,2072,6,2008/2009,2008-09-27 00:00:00,Everton,Liverpool,0,2,3.75,3.25,2.1,2,8,4,5,19,22,3,3,1,0,17,12,7,4,49.0,51.0,2,10,9,41,6,1,29,11
53,2073,6,2008/2009,2008-09-27 00:00:00,Middlesbrough,West Bromwich Albion,0,1,1.8,3.4,5.0,10,9,10,7,12,12,2,4,0,0,33,14,11,8,,,1,19,17,24,6,0,47,19
54,2074,6,2008/2009,2008-09-27 00:00:00,Newcastle United,Blackburn Rovers,1,2,2.6,3.3,2.75,1,6,3,2,8,20,0,4,0,0,25,12,5,5,54.0,46.0,3,7,5,28,4,0,37,10
55,2075,6,2008/2009,2008-09-27 00:00:00,Fulham,West Ham United,1,2,2.3,3.25,3.2,7,9,12,7,14,15,4,1,0,0,15,14,2,4,58.0,42.0,3,16,19,29,5,0,29,6
56,2077,6,2008/2009,2008-09-27 00:00:00,Stoke City,Chelsea,0,2,9.0,4.75,1.36,6,13,2,5,7,12,2,1,0,0,16,13,5,5,42.0,58.0,2,19,7,19,3,0,29,10
57,2076,6,2008/2009,2008-09-28 00:00:00,Portsmouth,Tottenham Hotspur,2,0,2.5,3.25,3.0,5,7,2,6,17,12,4,3,0,0,12,24,3,6,45.0,55.0,2,12,8,29,7,0,36,9
58,2078,6,2008/2009,2008-09-28 00:00:00,Wigan Athletic,Manchester City,2,1,3.0,3.3,2.38,4,8,6,5,12,21,3,4,0,0,12,11,5,3,51.0,49.0,3,12,11,33,7,0,23,8
59,2079,7,2008/2009,2008-10-04 00:00:00,Sunderland,Arsenal,1,1,6.0,3.75,1.62,5,6,3,9,12,15,3,5,0,0,6,18,1,7,39.0,61.0,2,11,12,27,8,0,24,8
60,2084,7,2008/2009,2008-10-04 00:00:00,Blackburn Rovers,Manchester United,0,2,6.0,3.75,1.62,4,8,3,8,9,9,2,1,0,0,16,24,3,4,39.0,61.0,2,12,11,18,3,0,40,7
61,2085,7,2008/2009,2008-10-04 00:00:00,West Bromwich Albion,Fulham,1,0,2.25,3.25,3.25,6,5,5,8,10,14,2,1,0,0,15,17,8,6,51.0,49.0,1,11,13,24,3,0,32,14
62,2087,7,2008/2009,2008-10-04 00:00:00,Wigan Athletic,Middlesbrough,0,1,2.1,3.3,3.6,11,2,12,4,11,12,3,0,0,0,26,16,8,2,55.0,45.0,1,13,16,23,3,0,42,10
63,2080,7,2008/2009,2008-10-05 00:00:00,Tottenham Hotspur,Hull City,0,1,1.73,3.75,4.75,15,4,13,4,15,15,4,2,0,0,28,1,12,0,69.0,31.0,1,19,17,30,6,0,29,12
64,2081,7,2008/2009,2008-10-05 00:00:00,West Ham United,Bolton Wanderers,1,3,1.83,3.4,4.75,5,6,9,6,15,7,4,3,0,0,21,14,7,7,50.0,50.0,4,11,15,22,7,0,35,14
65,2082,7,2008/2009,2008-10-05 00:00:00,Everton,Newcastle United,2,2,1.73,3.6,5.0,3,9,8,2,17,15,1,3,0,0,22,18,3,5,35.0,65.0,4,12,10,32,4,0,40,8
66,2083,7,2008/2009,2008-10-05 00:00:00,Manchester City,Liverpool,2,3,3.2,3.3,2.25,2,6,2,6,10,13,1,1,1,0,7,30,1,7,50.0,50.0,5,8,8,23,2,1,37,8
67,2086,7,2008/2009,2008-10-05 00:00:00,Portsmouth,Stoke City,2,1,1.67,3.4,6.0,11,3,8,4,7,15,0,3,0,0,14,25,2,4,57.0,43.0,3,14,12,22,3,0,39,6
68,2088,7,2008/2009,2008-10-05 00:00:00,Chelsea,Aston Villa,2,0,1.5,4.0,7.0,15,2,12,6,11,15,0,3,0,0,28,15,7,1,49.0,51.0,2,17,18,26,3,0,43,8
69,2089,8,2008/2009,2008-10-18 00:00:00,Manchester United,West Bromwich Albion,4,0,1.2,6.5,15.0,10,2,5,4,10,14,0,1,0,0,32,6,15,1,78.0,22.0,4,12,9,24,1,0,38,16
70,2090,8,2008/2009,2008-10-18 00:00:00,Arsenal,Everton,3,1,1.36,4.5,10.0,11,4,8,2,9,13,2,4,0,0,26,12,7,4,61.0,39.0,4,15,10,22,6,0,38,11
71,2091,8,2008/2009,2008-10-18 00:00:00,Liverpool,Wigan Athletic,3,2,1.4,4.33,9.0,8,3,9,3,10,15,1,1,0,0,28,8,4,2,60.0,40.0,5,11,12,25,2,0,36,6
72,2092,8,2008/2009,2008-10-18 00:00:00,Aston Villa,Portsmouth,0,0,1.83,3.25,5.0,6,3,8,5,19,19,1,3,0,0,28,6,11,2,58.0,42.0,0,9,13,38,4,0,34,13
73,2093,8,2008/2009,2008-10-18 00:00:00,Middlesbrough,Chelsea,0,5,6.0,3.7,1.62,4,8,6,8,13,9,2,0,0,0,15,19,5,8,40.0,60.0,5,12,14,22,2,0,34,13
74,2095,8,2008/2009,2008-10-18 00:00:00,Fulham,Sunderland,0,0,2.25,3.25,3.3,10,7,5,7,14,7,1,1,0,0,19,11,7,5,49.0,51.0,0,17,12,21,2,0,30,12
75,2096,8,2008/2009,2008-10-18 00:00:00,Bolton Wanderers,Blackburn Rovers,0,0,2.4,3.25,3.0,5,1,7,6,15,12,1,3,0,0,20,15,11,8,53.0,47.0,0,6,13,27,4,0,35,19
76,2097,8,2008/2009,2008-10-19 00:00:00,Hull City,West Ham United,1,0,2.62,3.25,2.75,3,7,9,8,11,11,2,1,0,0,22,25,3,4,46.0,54.0,1,10,17,22,3,0,47,7
77,2098,8,2008/2009,2008-10-19 00:00:00,Stoke City,Tottenham Hotspur,2,1,3.25,3.3,2.25,3,5,5,5,13,12,1,2,0,2,19,6,5,1,46.0,54.0,3,8,10,25,3,2,25,6
78,2094,8,2008/2009,2008-10-20 00:00:00,Newcastle United,Manchester City,2,2,3.0,3.25,2.4,2,10,3,12,14,15,0,2,1,0,11,16,5,10,40.0,60.0,4,12,15,29,2,1,27,15
79,2099,9,2008/2009,2008-10-25 00:00:00,Sunderland,Newcastle United,2,1,2.2,3.3,3.4,3,6,10,5,12,15,1,2,0,0,26,21,2,4,59.0,41.0,3,9,15,27,3,0,47,6
80,2102,9,2008/2009,2008-10-25 00:00:00,Everton,Manchester United,1,1,7.5,4.0,1.5,10,10,4,9,19,13,3,3,0,0,20,17,6,9,57.0,43.0,2,20,13,32,6,0,37,15
81,2104,9,2008/2009,2008-10-25 00:00:00,Blackburn Rovers,Middlesbrough,1,1,2.1,3.25,3.75,2,1,9,2,17,13,3,1,0,0,20,3,10,2,52.0,48.0,2,3,11,30,4,0,23,12
82,2105,9,2008/2009,2008-10-25 00:00:00,West Bromwich Albion,Hull City,0,3,2.2,3.3,3.4,14,6,13,6,11,15,1,2,0,0,16,11,14,5,47.0,53.0,3,20,19,26,3,0,27,19
83,2100,9,2008/2009,2008-10-26 00:00:00,Tottenham Hotspur,Bolton Wanderers,2,0,2.05,3.3,4.0,7,2,10,8,9,13,0,3,0,0,19,13,2,4,53.0,47.0,2,9,18,22,3,0,32,6
84,2101,9,2008/2009,2008-10-26 00:00:00,West Ham United,Arsenal,0,2,6.0,3.75,1.62,6,10,4,10,13,9,2,3,1,0,6,15,4,9,39.0,61.0,2,16,14,22,5,1,21,13
85,2103,9,2008/2009,2008-10-26 00:00:00,Manchester City,Stoke City,3,0,1.44,4.33,7.5,8,6,7,4,13,15,1,0,0,0,12,22,5,8,57.0,43.0,3,14,11,28,1,0,34,13
86,2106,9,2008/2009,2008-10-26 00:00:00,Portsmouth,Fulham,1,1,1.83,3.5,4.5,11,5,11,4,8,8,0,0,0,0,19,18,8,6,54.0,46.0,2,16,15,16,0,0,37,14
87,2107,9,2008/2009,2008-10-26 00:00:00,Wigan Athletic,Aston Villa,0,4,2.6,3.3,2.75,6,4,11,2,15,8,1,2,0,0,25,15,9,4,46.0,54.0,4,10,13,23,3,0,40,13
88,2108,9,2008/2009,2008-10-26 00:00:00,Chelsea,Liverpool,0,1,1.91,3.25,4.5,6,2,12,6,18,15,3,3,0,0,16,3,4,2,70.0,30.0,1,8,18,33,6,0,19,6
89,1747,10,2008/2009,2008-10-28 00:00:00,Newcastle United,West Bromwich Albion,2,1,1.83,3.5,4.5,4,5,6,9,15,12,0,4,0,0,17,15,7,8,51.0,49.0,3,9,15,27,4,0,32,15
90,1739,10,2008/2009,2008-10-29 00:00:00,Manchester United,West Ham United,2,0,1.2,6.0,19.0,11,3,8,3,11,15,1,2,0,0,14,6,3,1,60.0,40.0,2,14,11,26,3,0,20,4
91,1740,10,2008/2009,2008-10-29 00:00:00,Arsenal,Tottenham Hotspur,4,4,1.44,4.5,7.5,9,3,11,5,9,16,1,4,0,0,22,14,9,1,62.0,38.0,8,12,16,25,5,0,36,10
92,1741,10,2008/2009,2008-10-29 00:00:00,Middlesbrough,Manchester City,2,0,2.88,3.3,2.5,5,11,2,5,14,14,1,3,0,0,14,6,3,3,45.0,55.0,2,16,7,28,4,0,20,6
93,1742,10,2008/2009,2008-10-29 00:00:00,Bolton Wanderers,Everton,0,1,2.6,3.3,2.75,13,6,6,4,17,13,1,2,0,0,19,25,5,3,53.0,47.0,1,19,10,30,3,0,44,8
94,1743,10,2008/2009,2008-10-29 00:00:00,Hull City,Chelsea,0,3,8.0,4.33,1.44,4,3,7,18,12,13,0,2,0,0,10,18,5,4,,,3,7,25,25,2,0,28,9
95,1744,10,2008/2009,2008-10-29 00:00:00,Stoke City,Sunderland,1,0,2.6,3.3,2.75,4,4,6,6,12,8,2,1,0,0,22,11,5,3,52.0,48.0,1,8,12,20,3,0,33,8
96,1745,10,2008/2009,2008-10-29 00:00:00,Liverpool,Portsmouth,1,0,1.33,5.0,10.0,9,1,11,3,12,13,0,3,0,0,21,6,7,1,54.0,46.0,1,10,14,25,3,0,27,8
97,1746,10,2008/2009,2008-10-29 00:00:00,Aston Villa,Blackburn Rovers,3,2,1.67,3.75,5.5,2,7,5,6,9,17,0,1,0,0,13,11,4,5,57.0,43.0,5,9,11,26,1,0,24,9
98,1748,10,2008/2009,2008-10-29 00:00:00,Fulham,Wigan Athletic,2,0,2.38,3.3,3.0,1,4,8,4,10,14,0,2,0,0,12,21,2,2,50.0,50.0,2,5,12,24,2,0,33,4
99,1749,11,2008/2009,2008-11-01 00:00:00,Manchester United,Hull City,4,3,1.17,7.0,17.0,7,3,9,4,13,13,2,2,0,0,12,8,9,1,51.0,49.0,7,10,13,26,4,0,20,10
100,1750,11,2008/2009,2008-11-01 00:00:00,Tottenham Hotspur,Liverpool,2,1,3.5,3.3,2.1,5,5,4,11,17,12,1,2,0,0,14,14,3,4,49.0,51.0,3,10,15,29,3,0,28,7
101,1751,11,2008/2009,2008-11-01 00:00:00,Everton,Fulham,1,0,1.67,3.75,5.5,5,7,5,9,11,15,0,0,0,0,33,18,6,5,54.0,46.0,1,12,14,26,0,0,51,11
102,1752,11,2008/2009,2008-11-01 00:00:00,Middlesbrough,West Ham United,1,1,2.0,3.3,4.0,8,8,5,6,9,17,3,4,0,0,23,14,4,4,53.0,47.0,2,16,11,26,7,0,37,8
103,1755,11,2008/2009,2008-11-01 00:00:00,West Bromwich Albion,Blackburn Rovers,2,2,2.5,3.3,2.88,7,4,7,4,10,16,3,2,0,0,28,9,2,3,59.0,41.0,4,11,11,26,5,0,37,5
104,1756,11,2008/2009,2008-11-01 00:00:00,Portsmouth,Wigan Athletic,1,2,1.91,3.4,4.2,8,9,10,5,11,12,0,3,0,0,22,22,7,6,45.0,55.0,3,17,15,23,3,0,44,13
105,1757,11,2008/2009,2008-11-01 00:00:00,Stoke City,Arsenal,2,1,8.0,4.5,1.4,3,4,2,8,13,7,4,2,0,1,14,26,3,6,45.0,55.0,3,7,10,20,6,1,40,9
106,1758,11,2008/2009,2008-11-01 00:00:00,Chelsea,Sunderland,5,0,1.17,6.5,21.0,8,0,7,1,6,11,0,1,0,0,15,11,4,0,55.0,45.0,5,8,8,17,1,0,26,4
107,1754,11,2008/2009,2008-11-02 00:00:00,Bolton Wanderers,Manchester City,2,0,3.0,3.3,2.38,8,7,6,5,15,21,1,1,0,0,26,7,6,1,55.0,45.0,2,15,11,36,2,0,33,7
108,1753,11,2008/2009,2008-11-03 00:00:00,Newcastle United,Aston Villa,2,0,3.0,3.3,2.38,5,1,5,6,14,20,4,3,0,0,11,19,2,6,55.0,45.0,2,6,11,34,7,0,30,8
109,1759,12,2008/2009,2008-11-08 00:00:00,Arsenal,Manchester United,2,1,3.25,3.25,2.3,6,9,6,10,17,8,3,2,0,0,16,20,5,6,52.0,48.0,3,15,16,25,5,0,36,11
110,1760,12,2008/2009,2008-11-08 00:00:00,Liverpool,West Bromwich Albion,3,0,1.2,6.0,19.0,8,2,2,2,10,8,2,1,0,0,13,14,3,7,51.0,49.0,3,10,4,18,3,0,27,10
111,1761,12,2008/2009,2008-11-08 00:00:00,Sunderland,Portsmouth,1,2,2.38,3.3,3.0,4,3,4,4,8,9,2,1,0,0,21,17,8,3,55.0,45.0,3,7,8,17,3,0,38,11
112,1762,12,2008/2009,2008-11-08 00:00:00,West Ham United,Everton,1,3,2.6,3.25,2.8,11,3,5,8,10,10,1,1,0,0,22,26,9,4,55.0,45.0,4,14,13,20,2,0,48,13
113,1767,12,2008/2009,2008-11-08 00:00:00,Hull City,Bolton Wanderers,0,1,2.25,3.25,3.4,8,7,7,3,15,13,1,2,0,0,25,16,6,7,55.0,45.0,1,15,10,28,3,0,41,13
114,1768,12,2008/2009,2008-11-08 00:00:00,Wigan Athletic,Stoke City,0,0,1.8,3.4,5.0,9,1,8,1,10,13,1,3,0,0,35,12,5,3,57.0,43.0,0,10,9,23,4,0,47,8
115,1763,12,2008/2009,2008-11-09 00:00:00,Aston Villa,Middlesbrough,1,2,1.7,3.8,5.0,10,5,5,7,12,8,2,2,0,0,24,13,8,4,56.0,44.0,3,15,12,20,4,0,37,12
116,1764,12,2008/2009,2008-11-09 00:00:00,Manchester City,Tottenham Hotspur,1,2,2.25,3.3,3.3,6,5,2,7,12,12,1,2,1,1,20,25,4,4,45.0,55.0,3,11,9,24,3,2,45,8
117,1765,12,2008/2009,2008-11-09 00:00:00,Blackburn Rovers,Chelsea,0,2,8.0,4.33,1.44,3,9,4,7,14,10,2,1,0,0,12,25,5,9,40.0,60.0,2,12,11,24,3,0,37,14
118,1766,12,2008/2009,2008-11-09 00:00:00,Fulham,Newcastle United,2,1,2.38,3.25,3.1,5,6,5,7,13,12,2,2,0,0,25,18,6,1,53.0,47.0,3,11,12,25,4,0,43,7
119,1769,13,2008/2009,2008-11-15 00:00:00,Manchester United,Stoke City,5,0,1.14,7.5,23.0,11,0,6,2,6,16,1,2,0,0,17,12,3,0,58.0,42.0,5,11,8,22,3,0,29,3
120,1770,13,2008/2009,2008-11-15 00:00:00,Arsenal,Aston Villa,0,2,1.5,4.0,7.0,8,4,5,3,10,20,2,4,0,0,33,15,8,4,53.0,47.0,2,12,8,30,6,0,48,12
121,1771,13,2008/2009,2008-11-15 00:00:00,West Ham United,Portsmouth,0,0,2.5,3.25,2.88,10,6,6,7,7,13,0,1,0,0,18,12,8,8,50.0,50.0,0,16,13,20,1,0,30,16
122,1773,13,2008/2009,2008-11-15 00:00:00,Newcastle United,Wigan Athletic,2,2,2.1,3.3,3.6,6,4,10,9,9,13,1,3,0,0,23,22,4,10,54.0,46.0,4,10,19,22,4,0,45,14
123,1774,13,2008/2009,2008-11-15 00:00:00,Blackburn Rovers,Sunderland,1,2,2.0,3.4,3.8,8,5,9,3,10,10,3,4,0,0,24,21,11,8,50.0,50.0,3,13,12,20,7,0,45,19
124,1775,13,2008/2009,2008-11-15 00:00:00,Fulham,Tottenham Hotspur,2,1,3.3,3.3,2.25,13,5,3,4,8,9,1,0,0,0,21,18,10,3,52.0,48.0,3,18,7,17,1,0,39,13
125,1776,13,2008/2009,2008-11-15 00:00:00,Bolton Wanderers,Liverpool,0,2,6.0,3.75,1.62,10,7,6,8,7,9,1,1,0,0,21,16,7,3,48.0,52.0,2,17,14,16,2,0,37,10
126,1777,13,2008/2009,2008-11-15 00:00:00,West Bromwich Albion,Chelsea,0,3,12.0,5.0,1.3,3,7,10,7,8,8,0,3,0,0,15,24,3,10,49.0,51.0,3,10,17,16,3,0,39,13
127,1772,13,2008/2009,2008-11-16 00:00:00,Everton,Middlesbrough,1,1,1.83,3.5,4.5,7,2,8,7,10,15,0,2,0,0,33,16,10,1,55.0,45.0,2,9,15,25,2,0,49,11
128,1778,13,2008/2009,2008-11-16 00:00:00,Hull City,Manchester City,2,2,2.88,3.25,2.5,3,3,4,5,15,16,2,3,0,0,25,26,3,6,52.0,48.0,4,6,9,31,5,0,51,9
129,1779,14,2008/2009,2008-11-22 00:00:00,Liverpool,Fulham,0,0,1.25,5.5,15.0,8,5,12,0,7,7,0,0,0,0,27,10,9,3,53.0,47.0,0,13,12,14,0,0,37,12
130,1782,14,2008/2009,2008-11-22 00:00:00,Aston Villa,Manchester United,0,0,5.0,3.6,1.73,7,5,3,6,13,16,1,0,0,0,13,18,3,6,40.0,60.0,0,12,9,29,1,0,31,9
131,1783,14,2008/2009,2008-11-22 00:00:00,Middlesbrough,Bolton Wanderers,1,3,1.91,3.4,4.33,10,2,12,6,11,17,2,5,0,0,18,12,8,0,51.0,49.0,4,12,18,28,7,0,30,8
132,1784,14,2008/2009,2008-11-22 00:00:00,Manchester City,Arsenal,3,0,3.25,3.4,2.2,4,5,6,6,17,16,0,1,0,0,13,8,3,3,54.0,46.0,3,9,12,33,1,0,21,6
133,1785,14,2008/2009,2008-11-22 00:00:00,Portsmouth,Hull City,2,2,1.8,3.6,4.5,4,7,7,8,12,14,2,1,0,0,18,18,7,7,54.0,46.0,4,11,15,26,3,0,36,14
134,1786,14,2008/2009,2008-11-22 00:00:00,Stoke City,West Bromwich Albion,1,0,2.2,3.3,3.4,9,3,2,6,11,9,1,0,0,0,30,17,4,0,55.0,45.0,1,12,8,20,1,0,47,4
135,1788,14,2008/2009,2008-11-22 00:00:00,Chelsea,Newcastle United,0,0,1.2,6.0,19.0,17,0,16,2,12,14,0,2,0,0,28,6,8,1,61.0,39.0,0,17,18,26,2,0,34,9
136,1780,14,2008/2009,2008-11-23 00:00:00,Sunderland,West Ham United,0,1,2.1,3.4,3.5,4,6,11,5,12,16,2,1,0,0,54,9,4,2,56.0,44.0,1,10,16,28,3,0,63,6
137,1781,14,2008/2009,2008-11-23 00:00:00,Tottenham Hotspur,Blackburn Rovers,1,0,1.73,3.75,4.75,10,10,8,3,14,17,2,3,0,0,23,12,6,6,53.0,47.0,1,20,11,31,5,0,35,12
138,1787,14,2008/2009,2008-11-24 00:00:00,Wigan Athletic,Everton,1,0,2.5,3.3,2.88,7,5,6,5,9,8,0,0,0,0,21,27,3,3,48.0,52.0,1,12,11,17,0,0,48,6
139,1790,15,2008/2009,2008-11-29 00:00:00,Sunderland,Bolton Wanderers,1,4,2.25,3.3,3.3,6,4,7,6,8,9,4,0,0,0,18,13,5,6,51.0,49.0,5,10,13,17,4,0,31,11
140,1792,15,2008/2009,2008-11-29 00:00:00,Aston Villa,Fulham,0,0,1.57,3.8,6.5,6,2,12,3,8,16,0,2,0,0,38,14,11,4,56.0,44.0,0,8,15,24,2,0,52,15
141,1793,15,2008/2009,2008-11-29 00:00:00,Middlesbrough,Newcastle United,0,0,2.2,3.3,3.4,7,6,9,5,10,8,1,1,0,0,23,5,7,2,53.0,47.0,0,13,14,18,2,0,28,9
142,1796,15,2008/2009,2008-11-29 00:00:00,Stoke City,Hull City,1,1,2.4,3.4,2.88,8,5,7,2,15,20,2,3,0,0,26,10,5,3,53.0,47.0,2,13,9,35,5,0,36,8
143,1797,15,2008/2009,2008-11-29 00:00:00,Wigan Athletic,West Bromwich Albion,2,1,1.73,3.6,5.0,7,9,9,9,11,9,0,2,0,0,22,28,6,7,51.0,49.0,3,16,18,20,2,0,50,13
144,1791,15,2008/2009,2008-11-30 00:00:00,Tottenham Hotspur,Everton,0,1,1.91,3.5,4.0,6,5,10,2,10,16,1,3,0,0,22,13,5,1,51.0,49.0,1,11,12,26,4,0,35,6
145,1794,15,2008/2009,2008-11-30 00:00:00,Manchester City,Manchester United,0,1,4.33,3.6,1.83,1,8,8,5,17,16,2,5,0,0,13,19,3,8,49.0,51.0,1,9,13,33,7,0,32,11
146,1795,15,2008/2009,2008-11-30 00:00:00,Portsmouth,Blackburn Rovers,3,2,2.1,3.3,3.6,2,2,3,6,7,11,0,1,0,0,31,32,8,10,53.0,47.0,5,4,9,18,1,0,63,18
147,1798,15,2008/2009,2008-11-30 00:00:00,Chelsea,Arsenal,1,2,1.8,3.4,5.0,6,5,9,3,19,16,2,0,0,0,14,10,3,2,58.0,42.0,3,11,12,35,2,0,24,5
148,1789,15,2008/2009,2008-12-01 00:00:00,Liverpool,West Ham United,0,0,1.3,5.0,12.0,11,3,15,4,5,9,1,1,0,0,38,5,17,5,56.0,44.0,0,14,19,14,2,0,43,22
149,1799,16,2008/2009,2008-12-06 00:00:00,Manchester United,Sunderland,1,0,1.14,7.5,23.0,10,1,14,0,11,7,1,0,0,0,50,4,10,1,80.0,20.0,1,11,14,18,1,0,54,11
150,1800,16,2008/2009,2008-12-06 00:00:00,Arsenal,Wigan Athletic,1,0,1.33,4.75,11.0,3,7,9,7,14,15,1,2,0,0,12,15,8,3,60.0,40.0,1,10,16,29,3,0,27,11
151,1803,16,2008/2009,2008-12-06 00:00:00,Newcastle United,Stoke City,2,2,1.8,3.5,4.75,4,4,4,7,10,16,0,1,0,0,18,25,6,3,49.0,51.0,4,8,11,26,1,0,43,9
152,1804,16,2008/2009,2008-12-06 00:00:00,Blackburn Rovers,Liverpool,1,3,5.5,3.5,1.73,2,5,4,3,12,10,2,2,0,0,13,17,5,6,41.0,59.0,4,7,7,22,4,0,30,11
153,1805,16,2008/2009,2008-12-06 00:00:00,Fulham,Manchester City,1,1,2.6,3.2,2.8,7,7,4,8,6,5,2,1,0,0,20,16,10,7,56.0,44.0,2,14,12,11,3,0,36,17
154,1806,16,2008/2009,2008-12-06 00:00:00,Bolton Wanderers,Chelsea,0,2,7.0,3.8,1.53,8,4,11,4,14,16,2,1,0,0,17,5,10,2,46.0,54.0,2,12,15,30,3,0,22,12
155,1808,16,2008/2009,2008-12-06 00:00:00,Hull City,Middlesbrough,2,1,2.38,3.25,3.1,6,6,11,2,13,8,1,1,0,1,25,20,7,6,52.0,48.0,3,12,13,21,2,1,45,13
156,1802,16,2008/2009,2008-12-07 00:00:00,Everton,Aston Villa,2,3,2.62,3.25,2.75,7,3,3,0,16,15,2,1,0,0,35,14,8,6,61.0,39.0,5,10,3,31,3,0,49,14
157,1807,16,2008/2009,2008-12-07 00:00:00,West Bromwich Albion,Portsmouth,1,1,2.62,3.25,2.75,7,2,7,3,11,12,1,2,0,0,11,8,3,5,46.0,54.0,2,9,10,23,3,0,19,8
158,1801,16,2008/2009,2008-12-08 00:00:00,West Ham United,Tottenham Hotspur,0,2,2.75,3.25,2.62,5,9,9,4,15,15,2,0,0,0,19,25,7,5,53.0,47.0,2,14,13,30,2,0,44,12
159,1809,17,2008/2009,2008-12-13 00:00:00,Liverpool,Hull City,2,2,1.33,5.0,10.0,12,3,12,6,12,8,3,3,0,0,49,12,7,4,70.0,30.0,4,15,18,20,6,0,61,11
160,1810,17,2008/2009,2008-12-13 00:00:00,Sunderland,West Bromwich Albion,4,0,2.0,3.4,3.8,7,13,7,4,9,17,1,2,0,0,13,22,1,11,48.0,52.0,4,20,11,26,3,0,35,12
161,1811,17,2008/2009,2008-12-13 00:00:00,Tottenham Hotspur,Manchester United,0,0,4.5,3.5,1.83,5,10,5,5,11,11,1,1,0,0,14,28,4,14,38.0,62.0,0,15,10,22,2,0,42,18
162,1812,17,2008/2009,2008-12-13 00:00:00,Aston Villa,Bolton Wanderers,4,2,1.67,3.6,5.5,4,1,8,8,8,17,0,1,0,0,17,17,10,2,55.0,45.0,6,5,16,25,1,0,34,12
163,1813,17,2008/2009,2008-12-13 00:00:00,Middlesbrough,Arsenal,1,1,4.5,3.6,1.8,3,10,5,10,8,11,0,1,0,0,12,16,5,10,48.0,52.0,2,13,15,19,1,0,28,15
164,1814,17,2008/2009,2008-12-13 00:00:00,Manchester City,Everton,0,1,2.0,3.4,3.8,6,3,3,8,12,8,0,1,0,0,9,21,5,7,45.0,55.0,1,9,11,20,1,0,30,12
165,1816,17,2008/2009,2008-12-13 00:00:00,Stoke City,Fulham,0,0,2.5,3.25,2.88,0,7,6,4,16,4,1,1,0,0,20,21,5,6,43.0,57.0,0,7,10,20,2,0,41,11
166,1817,17,2008/2009,2008-12-13 00:00:00,Wigan Athletic,Blackburn Rovers,3,0,2.1,3.3,3.6,1,4,6,7,9,15,1,1,0,0,21,28,7,8,4.0,96.0,3,5,13,24,2,0,49,15
167,1815,17,2008/2009,2008-12-14 00:00:00,Portsmouth,Newcastle United,0,3,2.05,3.2,3.4,7,2,12,5,14,3,4,1,0,0,19,14,8,5,28.0,72.0,3,9,17,17,5,0,33,13
168,1818,17,2008/2009,2008-12-14 00:00:00,Chelsea,West Ham United,1,1,1.25,5.5,15.0,16,1,8,2,12,19,3,2,0,0,22,11,9,4,57.0,43.0,2,17,10,31,5,0,33,13
169,1821,18,2008/2009,2008-12-20 00:00:00,West Ham United,Aston Villa,0,1,3.0,3.4,2.37,12,6,6,6,7,9,2,1,0,0,25,21,7,6,59.0,41.0,1,18,12,16,3,0,46,13
170,1824,18,2008/2009,2008-12-20 00:00:00,Blackburn Rovers,Stoke City,3,0,1.83,3.5,4.5,6,4,2,9,13,12,0,2,0,0,12,31,2,6,45.0,55.0,3,10,11,25,2,0,43,8
171,1825,18,2008/2009,2008-12-20 00:00:00,Fulham,Middlesbrough,3,0,2.2,3.25,3.5,10,6,6,6,12,8,0,2,0,0,9,14,6,5,53.0,47.0,3,16,12,20,2,0,23,11
172,1826,18,2008/2009,2008-12-20 00:00:00,Bolton Wanderers,Portsmouth,2,1,2.2,3.25,3.4,8,7,10,4,12,17,1,1,0,0,21,10,6,3,60.0,40.0,3,15,14,29,2,0,31,9
173,1828,18,2008/2009,2008-12-20 00:00:00,Hull City,Sunderland,1,4,2.1,3.25,3.75,8,5,6,8,21,11,3,1,0,0,10,13,6,6,49.0,51.0,5,13,14,32,4,0,23,12
174,1820,18,2008/2009,2008-12-21 00:00:00,Arsenal,Liverpool,1,1,2.4,3.25,3.0,3,7,2,5,15,16,3,3,0,0,7,11,2,2,50.0,50.0,2,10,7,31,6,0,18,4
175,1823,18,2008/2009,2008-12-21 00:00:00,Newcastle United,Tottenham Hotspur,2,1,2.37,3.4,3.0,3,6,3,5,11,9,3,2,0,0,22,24,4,8,45.0,55.0,3,9,8,20,5,0,46,12
176,1827,18,2008/2009,2008-12-21 00:00:00,West Bromwich Albion,Manchester City,2,1,3.25,3.3,2.25,5,9,7,4,5,11,2,1,0,0,24,26,4,7,50.0,50.0,3,14,11,16,3,0,50,11
177,1822,18,2008/2009,2008-12-22 00:00:00,Everton,Chelsea,0,0,5.0,3.6,1.73,9,7,2,5,16,11,0,3,0,1,25,9,6,5,44.0,56.0,0,16,7,27,3,1,34,11
178,1829,19,2008/2009,2008-12-26 00:00:00,Liverpool,Bolton Wanderers,3,0,1.33,4.5,12.0,9,1,11,2,9,11,1,3,0,0,38,7,16,3,67.0,33.0,3,10,13,20,4,0,45,19
179,1830,19,2008/2009,2008-12-26 00:00:00,Sunderland,Blackburn Rovers,0,0,2.25,3.25,3.3,9,3,6,7,4,9,0,3,0,0,30,13,4,2,56.0,44.0,0,12,13,13,3,0,43,6
180,1831,19,2008/2009,2008-12-26 00:00:00,Tottenham Hotspur,Fulham,0,0,1.72,3.6,5.0,9,7,8,5,8,12,0,1,0,0,14,10,4,2,50.0,50.0,0,16,13,20,1,0,24,6
181,1832,19,2008/2009,2008-12-26 00:00:00,Aston Villa,Arsenal,2,2,2.5,3.3,2.87,7,3,5,3,10,10,4,4,0,0,39,9,6,6,45.0,55.0,4,10,8,20,8,0,48,12
182,1833,19,2008/2009,2008-12-26 00:00:00,Middlesbrough,Everton,0,1,2.5,3.3,2.87,5,4,2,6,26,17,5,1,0,0,13,24,5,8,54.0,46.0,1,9,8,43,6,0,37,13
183,1834,19,2008/2009,2008-12-26 00:00:00,Manchester City,Hull City,5,1,1.8,3.6,4.5,9,6,10,5,15,14,0,4,0,0,4,16,8,10,56.0,44.0,6,15,15,29,4,0,20,18
184,1835,19,2008/2009,2008-12-26 00:00:00,Portsmouth,West Ham United,1,4,2.2,3.25,3.4,15,6,6,7,12,9,1,3,0,0,37,17,9,5,56.0,44.0,5,21,13,21,4,0,54,14
185,1836,19,2008/2009,2008-12-26 00:00:00,Stoke City,Manchester United,0,1,12.0,5.0,1.3,4,8,3,9,13,9,4,2,0,0,15,23,6,9,48.0,52.0,1,12,12,22,6,0,38,15
186,1837,19,2008/2009,2008-12-26 00:00:00,Wigan Athletic,Newcastle United,2,1,2.25,3.3,3.25,9,3,6,2,14,11,2,3,0,1,19,7,7,4,50.0,50.0,3,12,8,25,5,1,26,11
187,1838,19,2008/2009,2008-12-26 00:00:00,Chelsea,West Bromwich Albion,2,0,1.14,7.5,21.0,14,5,9,5,7,6,1,0,0,0,20,16,7,5,62.0,38.0,2,19,14,13,1,0,36,12
188,1850,20,2008/2009,2008-12-28 00:00:00,Arsenal,Portsmouth,1,0,1.4,4.5,10.0,6,4,7,1,11,9,0,1,0,0,28,15,11,1,57.0,43.0,1,10,8,20,1,0,43,12
189,1851,20,2008/2009,2008-12-28 00:00:00,West Ham United,Stoke City,2,1,1.72,3.6,5.5,12,4,7,4,11,15,3,3,0,1,28,14,8,4,67.0,33.0,3,16,11,26,6,1,42,12
190,1852,20,2008/2009,2008-12-28 00:00:00,Everton,Sunderland,3,0,1.8,3.6,5.0,3,6,7,3,9,10,1,4,0,0,14,9,8,2,59.0,41.0,3,9,10,19,5,0,23,10
191,1853,20,2008/2009,2008-12-28 00:00:00,Newcastle United,Liverpool,1,5,5.0,3.6,1.8,6,11,3,5,6,10,2,1,0,0,13,17,4,8,45.0,55.0,6,17,8,16,3,0,30,12
192,1854,20,2008/2009,2008-12-28 00:00:00,Blackburn Rovers,Manchester City,2,2,2.62,3.3,2.87,7,1,5,10,14,12,2,1,0,0,14,10,4,3,51.0,49.0,4,8,15,26,3,0,24,7
193,1855,20,2008/2009,2008-12-28 00:00:00,Fulham,Chelsea,2,2,6.5,3.75,1.61,1,17,3,6,9,7,1,2,0,0,9,21,1,6,41.0,59.0,4,18,9,16,3,0,30,7
194,1856,20,2008/2009,2008-12-28 00:00:00,Bolton Wanderers,Wigan Athletic,0,1,2.3,3.25,3.4,9,6,7,4,13,15,2,3,0,0,19,19,8,7,44.0,56.0,1,15,11,28,5,0,38,15
195,1857,20,2008/2009,2008-12-28 00:00:00,West Bromwich Albion,Tottenham Hotspur,2,0,3.5,3.4,2.2,7,5,6,1,19,12,3,2,0,1,28,20,8,4,53.0,47.0,2,12,7,31,5,1,48,12
196,1849,20,2008/2009,2008-12-29 00:00:00,Manchester United,Middlesbrough,1,0,1.2,6.5,19.0,12,2,18,6,12,18,2,0,0,0,25,16,8,4,53.0,47.0,1,14,24,30,2,0,41,12
197,1858,20,2008/2009,2008-12-30 00:00:00,Hull City,Aston Villa,0,1,4.33,3.6,1.91,3,3,4,4,13,8,1,2,0,0,29,16,9,5,43.0,57.0,1,6,8,21,3,0,45,14
198,1860,21,2008/2009,2009-01-10 00:00:00,Arsenal,Bolton Wanderers,1,0,1.36,4.33,11.0,7,3,6,0,15,17,2,2,0,0,29,5,5,0,64.0,36.0,1,10,6,32,4,0,34,5
199,1861,21,2008/2009,2009-01-10 00:00:00,Aston Villa,West Bromwich Albion,2,1,1.4,4.33,9.0,14,6,9,3,11,20,1,1,0,0,31,20,10,7,53.0,47.0,3,20,12,31,2,0,51,17
200,1862,21,2008/2009,2009-01-10 00:00:00,Everton,Hull City,2,0,1.62,3.75,6.0,2,0,5,5,13,25,2,5,0,0,21,17,5,3,57.0,43.0,2,2,10,38,7,0,38,8
201,1863,21,2008/2009,2009-01-10 00:00:00,Middlesbrough,Sunderland,1,1,2.25,3.2,3.4,4,4,6,7,11,14,0,4,0,0,4,17,2,7,55.0,45.0,2,8,13,25,4,0,21,9
202,1864,21,2008/2009,2009-01-10 00:00:00,Newcastle United,West Ham United,2,2,2.2,3.3,3.4,7,9,11,3,11,18,1,0,0,0,22,6,8,3,54.0,46.0,4,16,14,29,1,0,28,11
203,1867,21,2008/2009,2009-01-10 00:00:00,Stoke City,Liverpool,0,0,10.0,4.5,1.36,0,5,6,5,11,12,2,2,0,0,26,13,4,5,35.0,65.0,0,5,11,23,4,0,39,9
204,1859,21,2008/2009,2009-01-11 00:00:00,Manchester United,Chelsea,3,0,2.2,3.2,3.5,6,6,5,4,14,17,3,5,0,0,14,13,6,3,56.0,44.0,3,12,9,31,8,0,27,9
205,1868,21,2008/2009,2009-01-11 00:00:00,Wigan Athletic,Tottenham Hotspur,1,0,2.5,3.25,2.88,5,4,8,2,11,15,3,3,0,0,23,9,7,4,51.0,49.0,1,9,10,26,6,0,32,11
206,1819,18,2008/2009,2009-01-14 00:00:00,Manchester United,Wigan Athletic,1,0,1.2,6.0,15.0,6,5,5,10,9,10,0,3,0,0,18,22,4,6,51.0,49.0,1,11,15,19,3,0,40,10
207,1870,22,2008/2009,2009-01-17 00:00:00,Sunderland,Aston Villa,1,2,3.25,3.25,2.25,4,2,2,3,14,15,4,2,0,0,19,22,7,6,50.0,50.0,3,6,5,29,6,0,41,13
208,1873,22,2008/2009,2009-01-17 00:00:00,Manchester City,Wigan Athletic,1,0,2.0,3.4,3.75,2,8,9,12,11,17,1,4,1,0,8,37,2,11,49.0,51.0,1,10,21,28,5,1,45,13
209,1874,22,2008/2009,2009-01-17 00:00:00,Blackburn Rovers,Newcastle United,3,0,2.0,3.4,3.8,3,3,5,6,16,11,2,3,0,0,11,18,2,5,54.0,46.0,3,6,11,27,5,0,29,7
210,1875,22,2008/2009,2009-01-17 00:00:00,Bolton Wanderers,Manchester United,0,1,8.0,3.8,1.5,3,13,5,5,12,6,1,1,0,0,16,19,1,8,41.0,59.0,1,16,10,18,2,0,35,9
211,1876,22,2008/2009,2009-01-17 00:00:00,West Bromwich Albion,Middlesbrough,3,0,2.38,3.3,3.0,6,3,4,6,16,4,0,2,0,1,16,12,5,3,41.0,59.0,3,9,10,20,2,1,28,8
212,1877,22,2008/2009,2009-01-17 00:00:00,Hull City,Arsenal,1,3,5.5,4.0,1.62,4,5,2,7,9,16,1,1,0,0,20,19,4,4,43.0,57.0,4,9,9,25,2,0,39,8
213,1878,22,2008/2009,2009-01-17 00:00:00,Chelsea,Stoke City,2,1,1.2,6.5,15.0,19,1,20,3,8,14,0,3,0,0,36,13,10,4,56.0,44.0,3,20,23,22,3,0,49,14
214,1871,22,2008/2009,2009-01-18 00:00:00,Tottenham Hotspur,Portsmouth,1,1,1.73,3.6,5.0,15,4,11,6,5,12,0,2,0,0,25,13,8,4,54.0,46.0,2,19,17,17,2,0,38,12
215,1872,22,2008/2009,2009-01-18 00:00:00,West Ham United,Fulham,3,1,2.1,3.3,3.6,6,5,6,4,12,18,1,3,0,0,13,13,3,2,59.0,41.0,4,11,10,30,4,0,26,5
216,1869,22,2008/2009,2009-01-19 00:00:00,Liverpool,Everton,1,1,1.62,3.75,6.0,5,5,4,1,20,17,0,2,0,0,12,15,4,4,56.0,44.0,2,10,5,37,2,0,27,8
217,1879,23,2008/2009,2009-01-27 00:00:00,Sunderland,Fulham,1,0,2.25,3.3,3.5,12,9,4,8,4,10,0,0,0,0,20,11,3,1,53.0,47.0,1,21,12,14,0,0,31,4
218,1880,23,2008/2009,2009-01-27 00:00:00,Tottenham Hotspur,Stoke City,3,1,1.61,3.8,6.5,11,1,8,5,18,24,2,3,0,0,22,17,7,4,58.0,42.0,4,12,13,42,5,0,39,11
219,1882,23,2008/2009,2009-01-27 00:00:00,West Bromwich Albion,Manchester United,0,5,10.0,5.0,1.36,4,6,10,6,13,8,5,2,1,0,14,10,5,4,39.0,61.0,5,10,16,21,7,1,24,9
220,1883,23,2008/2009,2009-01-27 00:00:00,Portsmouth,Aston Villa,0,1,3.25,3.4,2.3,8,2,12,7,10,12,2,2,0,0,26,15,17,5,54.0,46.0,1,10,19,22,4,0,41,22
221,1881,23,2008/2009,2009-01-28 00:00:00,West Ham United,Hull City,2,0,1.83,3.6,4.75,10,12,15,5,10,14,0,1,0,0,21,26,10,5,56.0,44.0,2,22,20,24,1,0,47,15
222,1884,23,2008/2009,2009-01-28 00:00:00,Wigan Athletic,Liverpool,1,1,5.0,3.5,1.83,2,3,3,6,11,18,1,0,0,0,15,14,2,2,48.0,52.0,2,5,9,29,1,0,29,4
223,1885,23,2008/2009,2009-01-28 00:00:00,Everton,Arsenal,1,1,3.0,3.3,2.5,4,4,4,3,10,14,2,2,0,0,13,15,7,6,49.0,51.0,2,8,7,24,4,0,28,13
224,1886,23,2008/2009,2009-01-28 00:00:00,Manchester City,Newcastle United,2,1,1.75,3.75,5.0,4,0,7,1,8,13,1,2,0,0,19,15,7,0,64.0,36.0,3,4,8,21,3,0,34,7
225,1887,23,2008/2009,2009-01-28 00:00:00,Blackburn Rovers,Bolton Wanderers,2,2,2.0,3.25,4.5,11,1,2,5,11,15,3,4,0,0,35,18,6,4,52.0,48.0,4,12,7,26,7,0,53,10
226,1888,23,2008/2009,2009-01-28 00:00:00,Chelsea,Middlesbrough,2,0,1.25,6.0,15.0,12,6,12,2,7,20,0,2,0,0,22,9,8,3,61.0,39.0,2,18,14,27,2,0,31,11
227,1889,24,2008/2009,2009-01-31 00:00:00,Manchester United,Everton,1,0,1.36,4.5,10.0,11,5,7,3,15,16,0,0,0,0,17,13,6,2,52.0,48.0,1,16,10,31,0,0,30,8
228,1890,24,2008/2009,2009-01-31 00:00:00,Arsenal,West Ham United,0,0,1.5,4.2,7.0,9,2,11,0,14,13,2,2,0,0,49,5,11,3,55.0,45.0,0,11,11,27,4,0,54,14
229,1892,24,2008/2009,2009-01-31 00:00:00,Aston Villa,Wigan Athletic,0,0,1.61,3.7,6.0,9,4,9,5,12,11,1,1,0,0,36,7,6,2,50.0,50.0,0,13,14,23,2,0,43,8
230,1893,24,2008/2009,2009-01-31 00:00:00,Middlesbrough,Blackburn Rovers,0,0,2.5,3.3,2.87,6,12,2,5,7,19,0,4,0,0,13,31,3,9,51.0,49.0,0,18,7,26,4,0,44,12
231,1895,24,2008/2009,2009-01-31 00:00:00,Fulham,Portsmouth,3,1,2.0,3.3,4.0,4,7,1,6,10,8,0,1,0,0,8,20,5,8,48.0,52.0,4,11,7,18,1,0,28,13
232,1896,24,2008/2009,2009-01-31 00:00:00,Bolton Wanderers,Tottenham Hotspur,3,2,2.75,3.3,2.62,5,8,6,4,10,11,0,1,0,0,14,26,2,8,46.0,54.0,5,13,10,21,1,0,40,10
233,1897,24,2008/2009,2009-01-31 00:00:00,Hull City,West Bromwich Albion,2,2,2.2,3.2,3.5,10,4,7,8,14,12,2,4,0,0,30,11,8,6,53.0,47.0,4,14,15,26,6,0,41,14
234,1898,24,2008/2009,2009-01-31 00:00:00,Stoke City,Manchester City,1,0,3.25,3.3,2.25,3,6,4,9,11,10,1,1,1,0,17,18,7,6,43.0,57.0,1,9,13,21,2,1,35,13
235,1891,24,2008/2009,2009-02-01 00:00:00,Liverpool,Chelsea,2,0,2.5,3.1,3.1,14,4,8,3,25,16,4,3,0,1,35,3,12,1,54.0,46.0,2,18,11,41,7,1,38,13
236,1894,24,2008/2009,2009-02-01 00:00:00,Newcastle United,Sunderland,1,1,2.6,3.2,2.8,14,10,7,8,14,20,2,4,0,0,35,12,4,3,51.0,49.0,2,24,15,34,6,0,47,7
237,1899,25,2008/2009,2009-02-07 00:00:00,Sunderland,Stoke City,2,0,1.83,3.5,4.5,6,2,6,3,4,11,2,1,0,1,29,17,2,3,60.0,40.0,2,8,9,15,3,1,46,5
238,1902,25,2008/2009,2009-02-07 00:00:00,Everton,Bolton Wanderers,3,0,1.72,3.4,5.5,8,5,12,3,10,18,1,1,0,0,27,16,8,4,68.0,32.0,3,13,15,28,2,0,43,12
239,1903,25,2008/2009,2009-02-07 00:00:00,Manchester City,Middlesbrough,1,0,1.61,3.75,6.0,14,5,9,4,7,12,0,1,0,0,21,14,12,3,61.0,39.0,1,19,13,19,1,0,35,15
240,1904,25,2008/2009,2009-02-07 00:00:00,Blackburn Rovers,Aston Villa,0,2,2.87,3.3,2.5,11,5,6,8,9,9,2,0,0,0,21,23,4,13,50.0,50.0,2,16,14,18,2,0,44,17
241,1905,25,2008/2009,2009-02-07 00:00:00,West Bromwich Albion,Newcastle United,2,3,2.25,3.3,3.25,4,6,6,5,7,11,2,2,0,0,32,18,3,4,49.0,51.0,5,10,11,18,4,0,50,7
242,1906,25,2008/2009,2009-02-07 00:00:00,Portsmouth,Liverpool,2,3,5.0,3.3,1.8,4,4,2,5,12,13,1,0,0,0,12,20,2,4,50.0,50.0,5,8,7,25,1,0,32,6
243,1907,25,2008/2009,2009-02-07 00:00:00,Wigan Athletic,Fulham,0,0,2.0,3.4,3.8,4,3,7,9,8,11,1,2,0,0,24,19,4,8,54.0,46.0,0,7,16,19,3,0,43,12
244,1908,25,2008/2009,2009-02-07 00:00:00,Chelsea,Hull City,0,0,1.2,6.0,19.0,12,3,9,9,13,22,1,2,0,0,25,8,13,3,59.0,41.0,0,15,18,35,3,0,33,16
245,1900,25,2008/2009,2009-02-08 00:00:00,Tottenham Hotspur,Arsenal,0,0,3.0,3.3,2.4,7,1,10,3,14,15,1,2,0,0,15,8,6,4,51.0,49.0,0,8,13,29,3,0,23,10
246,1901,25,2008/2009,2009-02-08 00:00:00,West Ham United,Manchester United,0,1,6.5,3.75,1.57,5,8,8,8,15,9,1,1,0,0,25,32,5,11,47.0,53.0,1,13,16,24,2,0,57,16
247,1866,21,2008/2009,2009-02-14 00:00:00,Portsmouth,Manchester City,2,0,2.87,3.25,2.5,6,8,8,3,12,9,1,3,0,0,27,11,8,2,55.0,45.0,2,14,11,21,4,0,38,10
248,1949,3,2008/2009,2009-02-18 00:00:00,Manchester United,Fulham,3,0,1.25,5.5,13.0,8,1,10,5,8,15,1,1,0,0,22,11,11,2,55.0,45.0,3,9,15,23,2,0,33,13
249,1909,26,2008/2009,2009-02-21 00:00:00,Manchester United,Blackburn Rovers,2,1,1.25,5.5,13.0,5,6,9,8,9,20,2,2,0,0,16,24,4,6,58.0,42.0,3,11,17,29,4,0,40,10
250,1910,26,2008/2009,2009-02-21 00:00:00,Arsenal,Sunderland,0,0,1.4,4.33,9.0,8,2,9,1,7,12,2,2,0,0,35,9,8,3,64.0,36.0,0,10,10,19,4,0,44,11
251,1912,26,2008/2009,2009-02-21 00:00:00,Aston Villa,Chelsea,0,1,3.3,3.3,2.25,6,9,8,9,10,12,1,3,0,0,28,19,6,11,42.0,58.0,1,15,17,22,4,0,47,17
252,1913,26,2008/2009,2009-02-21 00:00:00,Middlesbrough,Wigan Athletic,0,0,2.4,3.25,3.0,3,8,4,8,6,15,2,4,0,0,13,10,5,1,53.0,47.0,0,11,12,21,6,0,23,6
253,1916,26,2008/2009,2009-02-21 00:00:00,Bolton Wanderers,West Ham United,2,1,2.3,3.3,3.1,6,9,4,8,19,14,0,2,0,0,17,35,4,13,46.0,54.0,3,15,12,33,2,0,52,17
254,1918,26,2008/2009,2009-02-21 00:00:00,Stoke City,Portsmouth,2,2,2.5,3.25,2.87,2,3,3,3,7,11,1,3,0,0,23,26,2,3,54.0,46.0,4,5,6,18,4,0,49,5
255,1911,26,2008/2009,2009-02-22 00:00:00,Liverpool,Manchester City,1,1,1.57,3.75,7.0,7,4,13,4,11,13,1,2,0,0,28,9,6,4,52.0,48.0,2,11,17,24,3,0,37,10
256,1914,26,2008/2009,2009-02-22 00:00:00,Newcastle United,Everton,0,0,2.87,3.25,2.5,1,7,4,10,16,16,0,1,1,0,15,32,0,6,47.0,53.0,0,8,14,32,1,1,47,6
257,1915,26,2008/2009,2009-02-22 00:00:00,Fulham,West Bromwich Albion,2,0,1.8,3.5,4.75,10,7,12,4,12,9,0,1,0,0,18,17,12,4,54.0,46.0,2,17,16,21,1,0,35,16
258,1917,26,2008/2009,2009-02-23 00:00:00,Hull City,Tottenham Hotspur,1,2,3.0,3.3,2.37,3,6,10,4,16,9,2,1,0,0,32,19,11,13,47.0,53.0,3,9,14,25,3,0,51,24
259,1920,27,2008/2009,2009-02-28 00:00:00,Arsenal,Fulham,0,0,1.4,4.33,9.0,6,4,13,10,6,14,0,0,0,0,37,21,11,6,55.0,45.0,0,10,23,20,0,0,58,17
260,1924,27,2008/2009,2009-02-28 00:00:00,Everton,West Bromwich Albion,2,0,1.5,4.0,7.5,6,10,4,11,9,18,1,1,0,0,22,21,3,6,55.0,45.0,2,16,15,27,2,0,43,9
261,1925,27,2008/2009,2009-02-28 00:00:00,Middlesbrough,Liverpool,2,0,5.5,3.5,1.72,3,9,2,13,4,7,2,0,0,0,11,21,2,9,56.0,44.0,2,12,15,11,2,0,32,11
262,1928,27,2008/2009,2009-02-28 00:00:00,Chelsea,Wigan Athletic,2,1,1.28,5.0,13.0,12,6,4,6,14,15,3,2,0,0,33,19,12,8,57.0,43.0,3,18,10,29,5,0,52,20
263,1922,27,2008/2009,2009-03-01 00:00:00,West Ham United,Manchester City,1,0,2.5,3.25,2.87,10,5,2,7,16,18,2,2,0,0,20,20,4,7,50.0,50.0,1,15,9,34,4,0,40,11
264,1923,27,2008/2009,2009-03-01 00:00:00,Aston Villa,Stoke City,2,2,1.4,4.0,10.0,5,0,6,7,7,11,1,1,0,0,29,17,6,6,61.0,39.0,4,5,13,18,2,0,46,12
265,1926,27,2008/2009,2009-03-01 00:00:00,Bolton Wanderers,Newcastle United,1,0,2.0,3.3,4.0,5,12,3,10,14,10,2,3,0,0,14,25,1,10,52.0,48.0,1,17,13,24,5,0,39,11
266,1927,27,2008/2009,2009-03-01 00:00:00,Hull City,Blackburn Rovers,1,2,2.87,3.25,2.5,4,5,5,4,13,22,2,3,1,0,20,15,6,4,49.0,51.0,3,9,9,35,5,1,35,10
267,1930,28,2008/2009,2009-03-03 00:00:00,West Bromwich Albion,Arsenal,1,3,6.5,3.75,1.57,6,4,5,9,20,15,4,0,0,0,16,17,3,4,40.0,60.0,4,10,14,35,4,0,33,7
268,1931,28,2008/2009,2009-03-03 00:00:00,Portsmouth,Chelsea,0,1,6.5,3.75,1.57,6,10,6,10,7,16,0,0,0,0,13,22,6,5,50.0,50.0,1,16,16,23,0,0,35,11
269,1934,28,2008/2009,2009-03-03 00:00:00,Liverpool,Sunderland,2,0,1.4,4.33,9.5,11,2,10,4,9,6,1,1,0,0,36,8,7,2,58.0,42.0,2,13,14,15,2,0,44,9
270,1929,28,2008/2009,2009-03-04 00:00:00,Tottenham Hotspur,Middlesbrough,4,0,1.83,3.5,4.5,4,4,6,10,7,6,0,1,0,0,13,15,4,8,53.0,47.0,4,8,16,13,1,0,28,12
271,1932,28,2008/2009,2009-03-04 00:00:00,Stoke City,Bolton Wanderers,2,0,2.5,3.25,2.9,3,9,6,9,17,15,2,1,0,0,36,30,6,7,54.0,46.0,2,12,15,32,3,0,66,13
272,1933,28,2008/2009,2009-03-04 00:00:00,Wigan Athletic,West Ham United,0,1,2.2,3.3,3.4,8,2,11,4,9,10,2,5,1,0,27,1,8,1,56.0,44.0,1,10,15,19,7,1,28,9
273,1935,28,2008/2009,2009-03-04 00:00:00,Newcastle United,Manchester United,1,2,7.5,4.0,1.5,5,7,4,5,12,11,2,2,0,0,13,19,3,10,37.0,63.0,3,12,9,23,4,0,32,13
274,1936,28,2008/2009,2009-03-04 00:00:00,Manchester City,Aston Villa,2,0,2.5,3.3,2.87,6,5,6,3,7,10,1,2,0,0,14,21,6,5,51.0,49.0,2,11,9,17,3,0,35,11
275,1937,28,2008/2009,2009-03-04 00:00:00,Blackburn Rovers,Everton,0,0,2.5,3.25,2.9,4,5,7,4,12,15,1,0,0,0,14,15,2,4,50.0,50.0,0,9,11,27,1,0,29,6
276,1938,28,2008/2009,2009-03-04 00:00:00,Fulham,Hull City,0,1,1.66,3.6,5.75,10,2,8,10,12,16,3,1,0,0,38,18,13,5,49.0,51.0,1,12,18,28,4,0,56,18
277,1921,27,2008/2009,2009-03-07 00:00:00,Sunderland,Tottenham Hotspur,1,1,2.87,3.3,2.5,4,8,6,5,18,11,3,2,0,0,17,14,4,1,54.0,46.0,2,12,11,29,5,0,31,5
278,1865,21,2008/2009,2009-03-11 00:00:00,Fulham,Blackburn Rovers,1,2,2.25,3.2,3.4,8,7,4,9,13,7,1,1,0,0,16,24,9,8,49.0,51.0,3,15,13,20,2,0,40,17
279,1939,29,2008/2009,2009-03-14 00:00:00,Manchester United,Liverpool,1,4,1.91,3.3,4.5,8,3,8,2,12,16,2,3,1,0,23,10,10,3,61.0,39.0,5,11,10,28,5,1,33,13
280,1940,29,2008/2009,2009-03-14 00:00:00,Arsenal,Blackburn Rovers,4,0,1.44,4.33,8.0,9,4,6,3,10,16,0,4,0,0,24,15,7,4,57.0,43.0,4,13,9,26,4,0,39,11
281,1941,29,2008/2009,2009-03-14 00:00:00,Sunderland,Wigan Athletic,1,2,2.2,3.2,3.5,5,3,3,5,9,10,0,1,0,0,12,11,6,2,52.0,48.0,3,8,8,19,1,0,23,8
282,1944,29,2008/2009,2009-03-14 00:00:00,Everton,Stoke City,3,1,1.5,4.0,7.5,9,2,6,7,7,12,0,1,0,0,22,23,5,8,53.0,47.0,4,11,13,19,1,0,45,13
283,1945,29,2008/2009,2009-03-14 00:00:00,Middlesbrough,Portsmouth,1,1,2.2,3.2,3.5,8,3,11,6,12,12,1,3,0,0,44,14,12,4,49.0,51.0,2,11,17,24,4,0,58,16
284,1946,29,2008/2009,2009-03-14 00:00:00,Bolton Wanderers,Fulham,1,3,2.1,3.25,3.75,5,4,5,7,11,8,0,0,0,0,22,26,4,5,46.0,54.0,4,9,12,19,0,0,48,9
285,1947,29,2008/2009,2009-03-14 00:00:00,Hull City,Newcastle United,1,1,2.62,3.25,2.75,1,4,7,7,19,15,3,3,0,0,15,19,3,3,49.0,51.0,2,5,14,34,6,0,34,6
286,1943,29,2008/2009,2009-03-15 00:00:00,Aston Villa,Tottenham Hotspur,1,2,2.0,3.3,4.0,5,9,7,1,13,8,1,3,0,0,31,12,9,5,47.0,53.0,3,14,8,21,4,0,43,14
287,1948,29,2008/2009,2009-03-15 00:00:00,Chelsea,Manchester City,1,0,1.4,4.5,9.0,5,3,12,4,7,10,0,2,0,0,19,14,5,2,53.0,47.0,1,8,16,17,2,0,33,7
288,1942,29,2008/2009,2009-03-16 00:00:00,West Ham United,West Bromwich Albion,0,0,1.67,3.6,5.75,4,3,6,5,11,12,1,1,0,0,9,15,3,4,53.0,47.0,0,7,11,23,2,0,24,7
289,1960,30,2008/2009,2009-03-21 00:00:00,Tottenham Hotspur,Chelsea,1,0,4.5,3.5,1.83,6,11,4,8,14,8,2,2,0,0,15,14,8,7,50.0,50.0,1,17,12,22,4,0,29,15
290,1961,30,2008/2009,2009-03-21 00:00:00,Newcastle United,Arsenal,1,3,5.0,3.6,1.72,4,10,4,5,11,11,0,1,0,0,27,26,7,4,41.0,59.0,4,14,9,22,1,0,53,11
291,1963,30,2008/2009,2009-03-21 00:00:00,Blackburn Rovers,West Ham United,1,1,1.9,3.4,4.33,12,1,6,4,14,9,2,1,0,0,43,3,7,1,56.0,44.0,2,13,10,23,3,0,46,8
292,1964,30,2008/2009,2009-03-21 00:00:00,Fulham,Manchester United,2,0,8.0,4.2,1.44,11,13,9,6,13,12,2,4,0,1,16,13,3,4,54.0,46.0,2,24,15,25,6,1,29,7
293,1965,30,2008/2009,2009-03-21 00:00:00,West Bromwich Albion,Bolton Wanderers,1,1,2.4,3.3,3.0,2,9,10,5,11,12,2,1,0,0,34,21,8,4,50.0,50.0,2,11,15,23,3,0,55,12
294,1966,30,2008/2009,2009-03-21 00:00:00,Portsmouth,Everton,2,1,2.75,3.2,2.62,9,3,6,4,19,9,2,1,0,0,24,24,7,4,44.0,56.0,3,12,10,28,3,0,48,11
295,1967,30,2008/2009,2009-03-21 00:00:00,Stoke City,Middlesbrough,1,0,2.25,3.3,3.3,2,6,6,11,18,13,4,1,0,0,23,17,5,4,48.0,52.0,1,8,17,31,5,0,40,9
296,1959,30,2008/2009,2009-03-22 00:00:00,Liverpool,Aston Villa,5,0,1.44,4.2,8.0,4,4,6,3,9,12,1,3,0,1,11,19,4,6,57.0,43.0,5,8,9,21,4,1,30,10
297,1962,30,2008/2009,2009-03-22 00:00:00,Manchester City,Sunderland,1,0,1.66,3.6,5.5,10,4,9,3,15,13,3,5,0,1,15,18,7,8,61.0,39.0,1,14,12,28,8,1,33,15
298,1968,30,2008/2009,2009-03-22 00:00:00,Wigan Athletic,Hull City,1,0,1.72,3.6,5.0,6,3,10,8,14,14,1,3,0,0,21,18,4,4,47.0,53.0,1,9,18,28,4,0,39,8
299,1970,31,2008/2009,2009-04-04 00:00:00,Arsenal,Manchester City,2,0,1.53,3.75,7.5,7,4,10,6,10,10,1,3,0,0,16,3,7,2,58.0,42.0,2,11,16,20,4,0,19,9
300,1971,31,2008/2009,2009-04-04 00:00:00,West Ham United,Sunderland,2,0,2.1,3.2,3.75,7,8,6,5,10,8,1,1,0,0,11,21,10,8,52.0,48.0,2,15,11,18,2,0,32,18
301,1973,31,2008/2009,2009-04-04 00:00:00,Newcastle United,Chelsea,0,2,5.0,3.6,1.72,6,10,2,5,7,19,0,2,0,0,17,14,4,6,48.0,52.0,2,16,7,26,2,0,31,10
302,1974,31,2008/2009,2009-04-04 00:00:00,Blackburn Rovers,Tottenham Hotspur,2,1,2.62,3.25,2.75,5,4,5,5,14,11,1,1,0,0,20,16,5,7,49.0,51.0,3,9,10,25,2,0,36,12
303,1975,31,2008/2009,2009-04-04 00:00:00,Fulham,Liverpool,0,1,6.0,3.75,1.61,2,9,3,9,9,10,2,2,0,0,8,25,3,5,48.0,52.0,1,11,12,19,4,0,33,8
304,1976,31,2008/2009,2009-04-04 00:00:00,Bolton Wanderers,Middlesbrough,4,1,2.1,3.3,3.6,7,4,5,14,18,14,2,1,0,0,17,20,6,3,45.0,55.0,5,11,19,32,3,0,37,9
305,1977,31,2008/2009,2009-04-04 00:00:00,West Bromwich Albion,Stoke City,0,2,2.2,3.25,3.4,12,5,6,3,9,9,2,1,0,0,20,7,6,3,61.0,39.0,2,17,9,18,3,0,27,9
306,1978,31,2008/2009,2009-04-04 00:00:00,Hull City,Portsmouth,0,0,2.62,3.25,2.75,1,1,8,6,14,14,0,2,0,0,17,16,1,4,58.0,42.0,0,2,14,28,2,0,33,5
307,1969,31,2008/2009,2009-04-05 00:00:00,Manchester United,Aston Villa,3,2,1.4,4.33,9.0,6,4,7,3,12,18,1,2,0,0,29,18,8,4,53.0,47.0,5,10,10,30,3,0,47,12
308,1972,31,2008/2009,2009-04-05 00:00:00,Everton,Wigan Athletic,4,0,1.72,3.4,5.5,7,10,4,7,16,14,0,3,0,0,5,17,1,4,57.0,43.0,4,17,11,30,3,0,22,5
309,1979,32,2008/2009,2009-04-11 00:00:00,Liverpool,Blackburn Rovers,4,0,1.33,4.75,11.0,7,7,14,3,8,12,2,1,0,0,17,9,7,2,60.0,40.0,4,14,17,20,3,0,26,9
310,1980,32,2008/2009,2009-04-11 00:00:00,Sunderland,Manchester United,1,2,7.5,4.0,1.5,7,4,8,11,6,5,1,2,0,0,23,14,5,4,50.0,50.0,3,11,19,11,3,0,37,9
311,1981,32,2008/2009,2009-04-11 00:00:00,Tottenham Hotspur,West Ham United,1,0,1.73,3.5,5.5,9,5,8,3,10,17,1,5,0,0,41,19,10,1,60.0,40.0,1,14,11,27,6,0,60,11
312,1983,32,2008/2009,2009-04-11 00:00:00,Middlesbrough,Hull City,3,1,2.1,3.3,3.75,9,4,6,8,15,16,3,3,0,0,21,19,3,3,49.0,51.0,4,13,14,31,6,0,40,6
313,1985,32,2008/2009,2009-04-11 00:00:00,Portsmouth,West Bromwich Albion,2,2,1.73,3.5,5.5,2,4,9,5,12,10,3,1,0,0,20,11,5,2,50.0,50.0,4,6,14,22,4,0,31,7
314,1986,32,2008/2009,2009-04-11 00:00:00,Stoke City,Newcastle United,1,1,2.5,3.25,2.88,9,5,10,5,15,11,4,2,0,0,27,19,9,3,52.0,48.0,2,14,15,26,6,0,46,12
315,1987,32,2008/2009,2009-04-11 00:00:00,Wigan Athletic,Arsenal,1,4,5.25,3.5,1.73,3,1,8,11,13,18,3,3,0,0,20,11,6,5,41.0,59.0,5,4,19,31,6,0,31,11
316,1988,32,2008/2009,2009-04-11 00:00:00,Chelsea,Bolton Wanderers,4,3,1.25,5.5,15.0,10,4,11,9,11,17,0,0,0,0,9,11,8,5,60.0,40.0,7,14,20,28,0,0,20,13
317,1982,32,2008/2009,2009-04-12 00:00:00,Aston Villa,Everton,3,3,2.2,3.25,3.5,6,3,10,5,9,14,0,2,0,0,24,16,11,6,47.0,53.0,6,9,15,23,2,0,40,17
318,1984,32,2008/2009,2009-04-12 00:00:00,Manchester City,Fulham,1,3,1.91,3.4,4.33,6,9,10,4,10,8,0,1,0,0,16,10,8,3,47.0,53.0,4,15,14,18,1,0,26,11
319,1990,33,2008/2009,2009-04-18 00:00:00,Sunderland,Hull City,1,0,1.91,3.4,4.2,5,2,5,14,12,22,2,3,0,0,14,29,6,6,50.0,50.0,1,7,19,34,5,0,43,12
320,1992,33,2008/2009,2009-04-18 00:00:00,Aston Villa,West Ham United,1,1,1.67,3.6,5.5,7,9,10,7,9,11,2,3,0,0,27,14,12,11,50.0,50.0,2,16,17,20,5,0,41,23
321,1993,33,2008/2009,2009-04-18 00:00:00,Middlesbrough,Fulham,0,0,2.25,3.25,3.3,18,6,6,6,10,15,3,1,0,0,29,11,8,1,52.0,48.0,0,24,12,25,4,0,40,9
322,1995,33,2008/2009,2009-04-18 00:00:00,Portsmouth,Bolton Wanderers,1,0,2.1,3.3,3.6,13,1,11,4,10,15,2,4,0,0,38,21,6,5,53.0,47.0,1,14,15,25,6,0,59,11
323,1996,33,2008/2009,2009-04-18 00:00:00,Stoke City,Blackburn Rovers,1,0,2.4,3.25,3.0,2,4,5,3,14,7,3,1,0,0,32,20,4,6,57.0,43.0,1,6,8,21,4,0,52,10
324,1991,33,2008/2009,2009-04-19 00:00:00,Tottenham Hotspur,Newcastle United,1,0,1.67,3.6,5.5,18,5,5,5,12,17,1,2,0,0,18,18,4,7,52.0,48.0,1,23,10,29,3,0,36,11
325,1994,33,2008/2009,2009-04-19 00:00:00,Manchester City,West Bromwich Albion,4,2,1.57,3.8,6.5,9,12,5,11,15,13,1,2,0,0,10,25,3,9,57.0,43.0,6,21,16,28,3,0,35,12
326,1989,33,2008/2009,2009-04-21 00:00:00,Liverpool,Arsenal,4,4,1.72,3.6,5.0,13,0,8,4,10,12,0,1,0,0,25,3,12,0,52.0,48.0,8,13,12,22,1,0,28,12
327,1919,27,2008/2009,2009-04-22 00:00:00,Manchester United,Portsmouth,2,0,1.25,5.5,13.0,12,2,6,3,10,8,1,0,0,0,18,9,6,2,52.0,48.0,2,14,9,18,1,0,27,8
328,1998,33,2008/2009,2009-04-22 00:00:00,Chelsea,Everton,0,0,1.44,4.2,8.5,10,6,13,10,10,12,0,1,0,0,37,12,4,6,49.0,51.0,0,16,23,22,1,0,49,10
329,1999,34,2008/2009,2009-04-25 00:00:00,Manchester United,Tottenham Hotspur,5,2,1.44,4.0,9.0,12,2,6,2,18,12,3,3,0,0,24,10,6,2,53.0,47.0,7,14,8,30,6,0,34,8
330,2001,34,2008/2009,2009-04-25 00:00:00,West Ham United,Chelsea,0,1,4.75,3.3,1.85,6,11,3,11,10,11,1,0,0,0,4,12,3,5,42.0,58.0,1,17,14,21,1,0,16,8
331,2002,34,2008/2009,2009-04-25 00:00:00,Everton,Manchester City,1,2,1.83,3.5,4.5,5,7,7,7,11,14,1,3,0,0,21,8,5,3,52.0,48.0,3,12,14,25,4,0,29,8
332,2005,34,2008/2009,2009-04-25 00:00:00,Fulham,Stoke City,1,0,1.75,3.5,5.0,5,4,6,8,8,12,1,2,0,0,11,22,5,7,57.0,43.0,1,9,14,20,3,0,33,12
333,2006,34,2008/2009,2009-04-25 00:00:00,Bolton Wanderers,Aston Villa,1,1,3.1,3.3,2.37,5,6,3,7,15,10,0,1,0,0,25,29,5,5,48.0,52.0,2,11,10,25,1,0,54,10
334,2007,34,2008/2009,2009-04-25 00:00:00,West Bromwich Albion,Sunderland,3,0,2.5,3.3,2.87,6,4,4,4,8,10,0,1,0,0,20,13,6,3,49.0,51.0,3,10,8,18,1,0,33,9
335,2008,34,2008/2009,2009-04-25 00:00:00,Hull City,Liverpool,1,3,10.0,4.5,1.36,2,7,2,16,15,14,3,1,1,0,21,16,3,8,46.0,54.0,4,9,18,29,4,1,37,11
336,2000,34,2008/2009,2009-04-26 00:00:00,Arsenal,Middlesbrough,2,0,1.5,4.2,7.5,11,6,6,0,4,11,0,0,0,0,13,11,8,1,54.0,46.0,2,17,6,15,0,0,24,9
337,2004,34,2008/2009,2009-04-26 00:00:00,Blackburn Rovers,Wigan Athletic,2,0,1.9,3.4,4.2,8,11,6,10,9,12,0,0,0,0,25,27,4,7,54.0,46.0,2,19,16,21,0,0,52,11
338,2003,34,2008/2009,2009-04-27 00:00:00,Newcastle United,Portsmouth,0,0,2.0,3.5,3.75,7,6,4,9,10,7,2,2,0,0,21,20,6,10,52.0,48.0,0,13,13,17,4,0,41,16
339,2011,35,2008/2009,2009-05-02 00:00:00,Tottenham Hotspur,West Bromwich Albion,1,0,1.5,4.0,7.0,13,7,7,5,7,9,1,1,0,0,16,14,9,7,55.0,45.0,1,20,12,16,2,0,30,16
340,2013,35,2008/2009,2009-05-02 00:00:00,Middlesbrough,Manchester United,0,2,6.5,3.8,1.57,8,3,7,9,8,9,1,1,0,0,22,6,3,3,44.0,56.0,2,11,16,17,2,0,28,6
341,2014,35,2008/2009,2009-05-02 00:00:00,Manchester City,Blackburn Rovers,3,1,2.0,3.3,4.0,6,8,2,7,10,12,2,3,0,0,16,30,7,6,49.0,51.0,4,14,9,22,5,0,46,13
342,2015,35,2008/2009,2009-05-02 00:00:00,Portsmouth,Arsenal,0,3,3.2,3.3,2.3,5,6,8,6,8,10,3,1,1,0,13,27,5,11,48.0,52.0,3,11,14,18,4,1,40,16
343,2016,35,2008/2009,2009-05-02 00:00:00,Stoke City,West Ham United,0,1,2.37,3.25,3.1,5,2,7,4,7,10,3,2,0,0,47,14,7,0,47.0,53.0,1,7,11,17,5,0,61,7
344,2017,35,2008/2009,2009-05-02 00:00:00,Wigan Athletic,Bolton Wanderers,0,0,2.1,3.25,3.75,13,2,12,9,14,11,2,3,0,0,30,16,9,6,55.0,45.0,0,15,21,25,5,0,46,15
345,2018,35,2008/2009,2009-05-02 00:00:00,Chelsea,Fulham,3,1,1.53,3.8,7.0,4,2,8,7,7,7,0,1,0,0,10,11,5,4,56.0,44.0,4,6,15,14,1,0,21,9
346,2009,35,2008/2009,2009-05-03 00:00:00,Liverpool,Newcastle United,3,0,1.25,5.5,13.0,11,4,14,1,5,10,0,2,0,1,21,5,6,1,57.0,43.0,3,15,15,15,2,1,26,7
347,2010,35,2008/2009,2009-05-03 00:00:00,Sunderland,Everton,0,2,2.5,3.25,2.9,6,6,6,4,16,13,3,4,0,0,23,15,9,3,46.0,54.0,2,12,10,29,7,0,38,12
348,2012,35,2008/2009,2009-05-04 00:00:00,Aston Villa,Hull City,1,0,1.53,3.8,7.0,6,5,5,6,13,11,0,2,0,0,30,20,13,7,55.0,45.0,1,11,11,24,2,0,50,20
349,2021,36,2008/2009,2009-05-09 00:00:00,West Ham United,Liverpool,0,3,6.5,3.8,1.57,2,7,5,7,10,17,3,2,0,0,19,20,2,4,49.0,51.0,3,9,12,27,5,0,39,6
350,2022,36,2008/2009,2009-05-09 00:00:00,Everton,Tottenham Hotspur,0,0,2.3,3.3,3.2,6,0,7,3,16,13,2,3,0,0,28,23,4,5,51.0,49.0,0,6,10,29,5,0,51,9
351,2024,36,2008/2009,2009-05-09 00:00:00,Blackburn Rovers,Portsmouth,2,0,2.0,3.25,4.0,4,4,4,3,19,14,2,1,0,0,25,16,4,4,55.0,45.0,2,8,7,33,3,0,41,8
352,2025,36,2008/2009,2009-05-09 00:00:00,Fulham,Aston Villa,3,1,2.62,3.25,2.75,8,5,5,5,10,10,1,0,0,0,12,23,7,5,57.0,43.0,4,13,10,20,1,0,35,12
353,2026,36,2008/2009,2009-05-09 00:00:00,Bolton Wanderers,Sunderland,0,0,2.2,3.25,3.5,2,2,3,13,10,4,2,0,0,0,26,19,10,3,45.0,55.0,0,4,16,14,2,0,45,13
354,2027,36,2008/2009,2009-05-09 00:00:00,West Bromwich Albion,Wigan Athletic,3,1,2.4,3.4,2.9,6,6,4,8,11,9,2,0,0,0,16,12,5,3,50.0,50.0,4,12,12,20,2,0,28,8
355,2028,36,2008/2009,2009-05-09 00:00:00,Hull City,Stoke City,1,2,2.1,3.3,3.6,4,0,9,8,12,18,0,1,0,0,17,7,5,3,59.0,41.0,3,4,17,30,1,0,24,8
356,2019,36,2008/2009,2009-05-10 00:00:00,Manchester United,Manchester City,2,0,1.36,4.75,9.5,6,5,6,5,9,14,1,1,0,0,19,23,8,7,49.0,51.0,2,11,11,23,2,0,42,15
357,2020,36,2008/2009,2009-05-10 00:00:00,Arsenal,Chelsea,1,4,2.6,3.25,2.8,9,5,10,8,17,11,1,0,0,0,37,14,6,2,44.0,56.0,5,14,18,28,1,0,51,8
358,2023,36,2008/2009,2009-05-11 00:00:00,Newcastle United,Middlesbrough,3,1,2.0,3.4,3.8,7,4,11,6,9,15,3,2,0,0,26,17,10,1,57.0,43.0,4,11,17,24,5,0,43,11
359,1997,33,2008/2009,2009-05-13 00:00:00,Wigan Athletic,Manchester United,1,2,12.0,5.0,1.3,6,6,6,10,13,3,0,0,0,0,13,21,5,4,48.0,52.0,3,12,16,16,0,0,34,9
360,2029,37,2008/2009,2009-05-16 00:00:00,Manchester United,Arsenal,0,0,1.67,3.5,6.0,3,10,8,5,14,18,0,5,0,0,13,22,2,6,50.0,50.0,0,13,13,32,5,0,35,8
361,2030,37,2008/2009,2009-05-16 00:00:00,Tottenham Hotspur,Manchester City,2,1,1.83,3.5,4.5,9,4,8,5,5,8,0,1,0,0,23,26,4,7,51.0,49.0,3,13,13,13,1,0,49,11
362,2031,37,2008/2009,2009-05-16 00:00:00,Everton,West Ham United,3,1,1.73,3.6,5.0,6,6,9,4,14,14,1,2,0,1,31,8,6,3,63.0,37.0,4,12,13,28,3,1,39,9
363,2032,37,2008/2009,2009-05-16 00:00:00,Middlesbrough,Aston Villa,1,1,2.5,3.4,2.75,6,6,4,5,15,18,0,2,0,0,15,17,6,10,45.0,55.0,2,12,9,33,2,0,32,16
364,2033,37,2008/2009,2009-05-16 00:00:00,Newcastle United,Fulham,0,1,1.91,3.5,4.0,4,4,10,7,7,17,0,3,1,0,26,10,6,2,52.0,48.0,1,8,17,24,3,1,36,8
365,2034,37,2008/2009,2009-05-16 00:00:00,Bolton Wanderers,Hull City,1,1,2.2,3.3,3.4,8,9,5,9,13,8,1,2,0,0,15,34,5,6,51.0,49.0,2,17,14,21,3,0,49,11
366,2037,37,2008/2009,2009-05-16 00:00:00,Stoke City,Wigan Athletic,2,0,2.2,3.25,3.4,6,3,8,8,10,11,0,0,0,0,19,12,6,3,55.0,45.0,2,9,16,21,0,0,31,9
367,2035,37,2008/2009,2009-05-17 00:00:00,West Bromwich Albion,Liverpool,0,2,7.0,5.0,1.4,7,7,4,5,14,4,2,0,0,0,32,21,11,5,41.0,59.0,2,14,9,18,2,0,53,16
368,2038,37,2008/2009,2009-05-17 00:00:00,Chelsea,Blackburn Rovers,2,0,1.3,5.0,11.0,11,5,7,5,5,3,1,2,0,0,24,14,2,3,57.0,43.0,2,16,12,8,3,0,38,5
369,2036,37,2008/2009,2009-05-18 00:00:00,Portsmouth,Sunderland,3,1,2.1,3.2,3.75,2,8,4,12,11,7,1,0,0,0,11,16,5,6,43.0,57.0,4,10,16,18,1,0,27,11
370,2039,38,2008/2009,2009-05-24 00:00:00,Arsenal,Stoke City,4,1,1.33,5.0,10.0,9,1,13,2,10,11,1,0,0,0,9,1,6,0,57.0,43.0,5,10,15,21,1,0,10,6
371,2040,38,2008/2009,2009-05-24 00:00:00,Liverpool,Tottenham Hotspur,3,1,1.53,4.0,6.5,2,3,12,4,10,3,0,1,0,0,16,8,7,3,54.0,46.0,4,5,16,13,1,0,24,10
372,2041,38,2008/2009,2009-05-24 00:00:00,Sunderland,Chelsea,2,3,4.0,3.6,1.91,4,6,1,4,3,3,1,1,0,0,12,10,6,3,44.0,56.0,5,10,5,6,2,0,22,9
373,2042,38,2008/2009,2009-05-24 00:00:00,West Ham United,Middlesbrough,2,1,2.25,3.4,3.2,7,4,8,11,16,10,0,1,0,0,9,32,4,5,54.0,46.0,3,11,19,26,1,0,41,9
374,2043,38,2008/2009,2009-05-24 00:00:00,Aston Villa,Newcastle United,1,0,2.3,3.4,3.1,7,3,7,5,8,10,0,2,0,0,21,22,5,3,57.0,43.0,1,10,12,18,2,0,43,8
375,2044,38,2008/2009,2009-05-24 00:00:00,Manchester City,Bolton Wanderers,1,0,1.73,3.6,5.0,16,0,9,4,5,9,0,0,0,0,11,16,12,6,59.0,41.0,1,16,13,14,0,0,27,18
376,2045,38,2008/2009,2009-05-24 00:00:00,Blackburn Rovers,West Bromwich Albion,0,0,1.83,3.5,4.5,4,6,4,7,14,10,0,1,1,0,11,16,4,9,49.0,51.0,0,10,11,24,1,1,27,13
377,2046,38,2008/2009,2009-05-24 00:00:00,Fulham,Everton,0,2,2.1,3.3,3.6,8,12,9,5,15,10,0,0,0,0,14,12,2,2,52.0,48.0,2,20,14,25,0,0,26,4
378,2047,38,2008/2009,2009-05-24 00:00:00,Hull City,Manchester United,0,1,3.0,3.5,2.3,9,4,4,7,19,12,2,1,0,0,25,10,8,2,52.0,48.0,1,13,11,31,3,0,35,10
379,2048,38,2008/2009,2009-05-24 00:00:00,Wigan Athletic,Portsmouth,1,0,2.1,3.4,3.5,9,3,10,7,9,22,0,4,0,0,15,7,8,2,49.0,51.0,1,12,17,31,4,0,22,10
380,2111,1,2009/2010,2009-08-15 00:00:00,Aston Villa,Wigan Athletic,0,2,1.67,3.6,5.5,4,8,7,6,15,15,2,2,0,0,20,7,4,6,42.0,58.0,2,12,13,30,4,0,27,10
381,2112,1,2009/2010,2009-08-15 00:00:00,Everton,Arsenal,1,6,3.2,3.25,2.3,5,4,3,8,11,12,0,0,0,0,13,19,4,9,45.0,55.0,7,9,11,23,0,0,32,13
382,2113,1,2009/2010,2009-08-15 00:00:00,Wolverhampton Wanderers,West Ham United,0,2,2.63,3.3,2.7,10,9,10,5,9,6,0,0,0,0,31,16,8,6,48.0,52.0,2,19,15,15,0,0,47,14
383,2114,1,2009/2010,2009-08-15 00:00:00,Blackburn Rovers,Manchester City,0,2,3.6,3.25,2.1,8,3,4,3,11,11,2,1,0,0,26,11,6,4,47.0,53.0,2,11,7,22,3,0,37,10
384,2115,1,2009/2010,2009-08-15 00:00:00,Bolton Wanderers,Sunderland,0,1,2.25,3.25,3.25,4,9,9,7,14,9,2,1,0,0,22,20,3,7,43.0,57.0,1,13,16,23,3,0,42,10
385,2116,1,2009/2010,2009-08-15 00:00:00,Portsmouth,Fulham,0,1,2.63,3.2,2.75,4,3,11,6,11,18,3,2,0,0,21,8,6,4,50.0,50.0,1,7,17,29,5,0,29,10
386,2117,1,2009/2010,2009-08-15 00:00:00,Stoke City,Burnley,2,0,1.91,3.3,4.33,4,10,8,4,16,10,2,2,0,0,14,13,3,6,52.0,48.0,2,14,12,26,4,0,27,9
387,2118,1,2009/2010,2009-08-15 00:00:00,Chelsea,Hull City,2,1,1.17,6.5,21.0,13,3,16,4,14,16,1,2,0,0,25,15,11,4,50.0,50.0,3,16,20,30,3,0,40,15
388,2109,1,2009/2010,2009-08-16 00:00:00,Manchester United,Birmingham City,1,0,1.2,6.0,17.0,18,3,11,3,13,8,1,1,0,0,27,16,12,2,55.0,45.0,1,21,14,21,2,0,43,14
389,2110,1,2009/2010,2009-08-16 00:00:00,Tottenham Hotspur,Liverpool,2,1,3.2,3.25,2.3,9,3,8,4,12,14,3,3,0,0,17,24,6,5,57.0,43.0,3,12,12,26,6,0,41,11
390,2220,2,2009/2010,2009-08-18 00:00:00,Sunderland,Chelsea,1,3,6.5,4.0,1.53,2,8,1,11,14,12,2,2,0,0,3,39,1,14,37.0,63.0,4,10,12,26,4,0,42,15
391,2226,2,2009/2010,2009-08-18 00:00:00,Wigan Athletic,Wolverhampton Wanderers,0,1,1.73,3.6,5.25,6,3,11,6,8,20,0,3,0,0,14,15,4,4,56.0,44.0,1,9,17,28,3,0,29,8
392,2223,2,2009/2010,2009-08-19 00:00:00,Birmingham City,Portsmouth,1,0,2.0,3.3,4.0,8,7,4,4,10,19,0,5,0,0,21,8,4,5,47.0,53.0,1,15,8,29,5,0,29,9
393,2224,2,2009/2010,2009-08-19 00:00:00,Hull City,Tottenham Hotspur,1,5,3.75,3.5,2.0,6,7,3,8,23,12,3,2,0,0,18,11,6,5,35.0,65.0,6,13,11,35,5,0,29,11
394,2225,2,2009/2010,2009-08-19 00:00:00,Burnley,Manchester United,1,0,9.5,5.0,1.33,2,10,6,9,8,10,2,1,0,0,10,37,1,12,36.0,64.0,1,12,15,18,3,0,47,13
395,2227,2,2009/2010,2009-08-19 00:00:00,Liverpool,Stoke City,4,0,1.25,5.5,13.0,11,3,4,4,11,9,0,1,0,0,23,14,11,5,53.0,47.0,4,14,8,20,1,0,37,16
396,2329,3,2009/2010,2009-08-22 00:00:00,Arsenal,Portsmouth,4,1,1.17,7.0,19.0,15,5,4,5,9,9,1,0,0,0,23,9,8,4,58.0,42.0,5,20,9,18,1,0,32,12
397,2331,3,2009/2010,2009-08-22 00:00:00,Sunderland,Blackburn Rovers,2,1,2.1,3.25,3.75,4,7,4,14,13,17,2,1,0,0,12,26,0,10,53.0,47.0,3,11,18,30,3,0,38,10
398,2333,3,2009/2010,2009-08-22 00:00:00,Manchester City,Wolverhampton Wanderers,1,0,1.33,4.5,12.0,11,4,5,8,9,11,0,1,0,0,10,13,5,6,63.0,37.0,1,15,13,20,1,0,23,11
399,2335,3,2009/2010,2009-08-22 00:00:00,Birmingham City,Stoke City,0,0,2.3,3.2,3.25,5,2,6,9,10,16,0,3,0,0,12,30,3,3,49.0,51.0,0,7,15,26,3,0,42,6
400,2336,3,2009/2010,2009-08-22 00:00:00,Hull City,Bolton Wanderers,1,0,2.6,3.25,2.8,3,12,8,11,18,17,3,2,0,0,14,38,4,12,43.0,57.0,1,15,19,35,5,0,52,16
401,2338,3,2009/2010,2009-08-22 00:00:00,Wigan Athletic,Manchester United,0,5,6.5,4.0,1.53,7,9,4,2,9,10,2,2,0,0,16,25,3,5,48.0,52.0,5,16,6,19,4,0,41,8
402,2332,3,2009/2010,2009-08-23 00:00:00,West Ham United,Tottenham Hotspur,1,2,3.1,3.25,2.38,8,9,8,7,13,9,2,1,0,0,21,28,4,9,51.0,49.0,3,17,15,22,3,0,49,13
403,2334,3,2009/2010,2009-08-23 00:00:00,Fulham,Chelsea,0,2,6.5,3.8,1.57,1,5,3,8,7,4,0,0,0,0,13,23,4,6,40.0,60.0,2,6,11,11,0,0,36,10
404,2337,3,2009/2010,2009-08-23 00:00:00,Burnley,Everton,1,0,3.4,3.3,2.2,5,11,5,9,12,12,1,0,0,0,12,26,3,7,39.0,61.0,1,16,14,24,1,0,38,10
405,2330,3,2009/2010,2009-08-24 00:00:00,Liverpool,Aston Villa,1,3,1.44,4.2,8.0,15,3,7,2,13,11,3,2,0,0,26,11,10,4,48.0,52.0,4,18,9,24,5,0,37,14
406,2429,4,2009/2010,2009-08-29 00:00:00,Manchester United,Arsenal,2,1,2.2,3.3,3.5,6,4,6,7,21,15,3,6,0,0,12,9,6,5,47.0,53.0,3,10,13,36,9,0,21,11
407,2430,4,2009/2010,2009-08-29 00:00:00,Tottenham Hotspur,Birmingham City,2,1,1.36,4.75,9.0,15,4,6,6,7,7,2,2,0,0,30,12,6,3,55.0,45.0,3,19,12,14,4,0,42,9
408,2433,4,2009/2010,2009-08-29 00:00:00,Wolverhampton Wanderers,Hull City,1,1,2.1,3.3,3.6,14,2,7,2,9,14,0,2,0,0,28,19,8,2,54.0,46.0,2,16,9,23,2,0,47,10
409,2434,4,2009/2010,2009-08-29 00:00:00,Blackburn Rovers,West Ham United,0,0,2.2,3.3,3.5,8,4,13,7,12,18,1,3,0,0,22,7,5,2,54.0,46.0,0,12,20,30,4,0,29,7
410,2435,4,2009/2010,2009-08-29 00:00:00,Bolton Wanderers,Liverpool,2,3,7.0,4.0,1.53,3,13,2,13,15,8,3,1,0,0,11,17,5,11,37.0,63.0,5,16,15,23,4,0,28,16
411,2437,4,2009/2010,2009-08-29 00:00:00,Stoke City,Sunderland,1,0,2.38,3.25,3.2,5,6,5,2,11,10,0,2,0,0,30,30,10,10,49.0,51.0,1,11,7,21,2,0,60,20
412,2438,4,2009/2010,2009-08-29 00:00:00,Chelsea,Burnley,3,0,1.14,8.0,21.0,17,2,16,3,8,6,0,1,0,0,24,9,10,1,64.0,36.0,3,19,19,14,1,0,33,11
413,2431,4,2009/2010,2009-08-30 00:00:00,Aston Villa,Fulham,2,0,1.73,3.6,5.25,1,2,6,3,10,9,1,2,0,0,18,9,9,4,56.0,44.0,2,3,9,19,3,0,27,13
414,2432,4,2009/2010,2009-08-30 00:00:00,Everton,Wigan Athletic,2,1,1.73,3.6,5.25,14,5,12,5,10,24,1,5,0,0,26,10,12,4,56.0,44.0,3,19,17,34,6,0,36,16
415,2436,4,2009/2010,2009-08-30 00:00:00,Portsmouth,Manchester City,0,1,6.5,3.8,1.57,7,7,6,4,13,7,2,1,0,0,14,26,3,11,42.0,58.0,1,14,10,20,3,0,40,14
416,2439,5,2009/2010,2009-09-12 00:00:00,Liverpool,Burnley,4,0,1.2,6.5,15.0,11,4,12,3,8,10,0,2,0,0,33,15,7,5,59.0,41.0,4,15,15,18,2,0,48,12
417,2440,5,2009/2010,2009-09-12 00:00:00,Sunderland,Hull City,4,1,1.75,3.5,5.0,4,5,2,3,20,17,2,2,0,0,22,13,7,8,55.0,45.0,5,9,5,37,4,0,35,15
418,2441,5,2009/2010,2009-09-12 00:00:00,Tottenham Hotspur,Manchester United,1,3,3.1,3.4,2.3,7,12,5,3,12,11,3,2,0,0,16,22,3,8,49.0,51.0,4,19,8,23,5,0,38,11
419,2442,5,2009/2010,2009-09-12 00:00:00,Manchester City,Arsenal,4,2,2.88,3.25,2.5,3,7,5,11,14,12,3,2,0,0,7,24,3,12,42.0,58.0,6,10,16,26,5,0,31,15
420,2443,5,2009/2010,2009-09-12 00:00:00,Blackburn Rovers,Wolverhampton Wanderers,3,1,1.83,3.5,4.5,4,3,3,4,13,14,1,2,0,0,27,17,9,6,58.0,42.0,4,7,7,27,3,0,44,15
421,2446,5,2009/2010,2009-09-12 00:00:00,Portsmouth,Bolton Wanderers,2,3,2.6,3.2,2.8,8,6,13,10,14,12,2,0,0,0,34,23,7,5,52.0,48.0,5,14,23,26,2,0,57,12
422,2447,5,2009/2010,2009-09-12 00:00:00,Stoke City,Chelsea,1,2,9.0,4.5,1.4,1,14,2,8,12,10,3,3,0,0,15,41,5,13,38.0,62.0,3,15,10,22,6,0,56,18
423,2448,5,2009/2010,2009-09-12 00:00:00,Wigan Athletic,West Ham United,1,0,2.3,3.25,3.25,6,6,6,7,14,11,2,1,0,0,15,10,6,7,51.0,49.0,1,12,13,25,3,0,25,13
424,2444,5,2009/2010,2009-09-13 00:00:00,Fulham,Everton,2,1,2.6,3.2,2.8,10,9,8,1,5,16,1,1,0,0,26,24,6,4,55.0,45.0,3,19,9,21,2,0,50,10
425,2445,5,2009/2010,2009-09-13 00:00:00,Birmingham City,Aston Villa,0,1,3.4,3.25,2.25,7,4,5,8,7,16,1,2,0,0,21,16,7,1,55.0,45.0,1,11,13,23,3,0,37,8
426,2450,6,2009/2010,2009-09-19 00:00:00,Arsenal,Wigan Athletic,4,0,1.25,5.5,13.0,10,5,12,3,4,16,2,2,0,0,25,10,4,4,70.0,30.0,4,15,15,20,4,0,35,8
427,2451,6,2009/2010,2009-09-19 00:00:00,West Ham United,Liverpool,2,3,6.5,4.0,1.53,4,10,4,4,14,18,3,3,0,0,7,10,4,4,48.0,52.0,5,14,8,32,6,0,17,8
428,2452,6,2009/2010,2009-09-19 00:00:00,Aston Villa,Portsmouth,2,0,1.4,4.2,10.0,5,12,2,7,17,13,2,0,0,0,25,24,7,5,52.0,48.0,2,17,9,30,2,0,49,12
429,2455,6,2009/2010,2009-09-19 00:00:00,Bolton Wanderers,Stoke City,1,1,2.1,3.25,3.75,5,6,6,2,7,14,2,2,0,0,31,30,4,7,48.0,52.0,2,11,8,21,4,0,61,11
430,2456,6,2009/2010,2009-09-19 00:00:00,Hull City,Birmingham City,0,1,2.4,3.25,3.0,8,8,7,6,13,11,0,2,0,0,20,15,10,8,45.0,55.0,1,16,13,24,2,0,35,18
431,2457,6,2009/2010,2009-09-19 00:00:00,Burnley,Sunderland,3,1,2.88,3.25,2.5,1,4,6,4,2,14,0,3,0,0,14,20,4,4,50.0,50.0,4,5,10,16,3,0,34,8
432,2449,6,2009/2010,2009-09-20 00:00:00,Manchester United,Manchester City,4,3,1.57,4.0,6.0,8,3,10,4,14,15,2,2,0,0,47,10,11,1,60.0,40.0,7,11,14,29,4,0,57,12
433,2453,6,2009/2010,2009-09-20 00:00:00,Everton,Blackburn Rovers,3,0,1.8,3.3,5.0,9,6,10,3,15,20,1,2,0,0,20,12,6,2,51.0,49.0,3,15,13,35,3,0,32,8
434,2454,6,2009/2010,2009-09-20 00:00:00,Wolverhampton Wanderers,Fulham,2,1,2.5,3.25,2.88,3,5,8,2,15,10,1,1,0,0,25,21,3,3,51.0,49.0,3,8,10,25,2,0,46,6
435,2458,6,2009/2010,2009-09-20 00:00:00,Chelsea,Tottenham Hotspur,3,0,1.5,4.0,7.0,13,3,8,4,6,10,0,2,0,0,33,16,11,3,55.0,45.0,3,16,12,16,2,0,49,14
436,2459,7,2009/2010,2009-09-26 00:00:00,Liverpool,Hull City,6,1,1.14,7.5,23.0,5,3,12,6,9,5,1,4,0,0,32,10,13,2,54.0,46.0,7,8,18,14,5,0,42,15
437,2460,7,2009/2010,2009-09-26 00:00:00,Tottenham Hotspur,Burnley,5,0,1.33,5.0,10.0,9,8,7,4,7,10,1,1,0,0,15,20,2,7,53.0,47.0,5,17,11,17,2,0,35,9
438,2461,7,2009/2010,2009-09-26 00:00:00,Wigan Athletic,Chelsea,3,1,10.0,5.0,1.33,8,6,6,7,11,15,1,2,0,1,4,12,4,7,51.0,49.0,4,14,13,26,3,1,16,11
439,2463,7,2009/2010,2009-09-26 00:00:00,Stoke City,Manchester United,0,2,8.5,4.5,1.4,1,5,1,6,12,8,1,1,0,0,6,21,2,7,41.0,59.0,2,6,7,20,2,0,27,9
440,2464,7,2009/2010,2009-09-26 00:00:00,Portsmouth,Everton,0,1,4.2,3.4,1.91,12,8,6,4,14,17,0,3,0,0,21,18,5,6,45.0,55.0,1,20,10,31,3,0,39,11
441,2466,7,2009/2010,2009-09-26 00:00:00,Fulham,Arsenal,0,1,6.5,4.0,1.53,11,3,8,11,13,12,4,0,0,0,20,13,4,6,45.0,55.0,1,14,19,25,4,0,33,10
442,2467,7,2009/2010,2009-09-26 00:00:00,Blackburn Rovers,Aston Villa,2,1,3.1,3.25,2.38,9,3,7,4,14,15,2,3,0,0,24,23,6,5,52.0,48.0,3,12,11,29,5,0,47,11
443,2468,7,2009/2010,2009-09-26 00:00:00,Birmingham City,Bolton Wanderers,1,2,2.2,3.25,3.4,5,4,6,5,9,13,2,1,0,0,39,19,8,4,49.0,51.0,3,9,11,22,3,0,58,12
444,2462,7,2009/2010,2009-09-27 00:00:00,Sunderland,Wolverhampton Wanderers,5,2,1.73,3.6,5.0,7,13,1,4,20,12,1,3,0,0,16,30,7,9,55.0,45.0,7,20,5,32,4,0,46,16
445,2465,7,2009/2010,2009-09-28 00:00:00,Manchester City,West Ham United,3,1,1.44,4.33,7.5,9,6,8,5,18,16,1,1,0,0,16,7,11,5,50.0,50.0,4,15,13,34,2,0,23,16
446,2469,8,2009/2010,2009-10-03 00:00:00,Manchester United,Sunderland,2,2,1.2,6.5,15.0,13,1,6,1,11,17,2,3,0,0,44,10,14,1,54.0,46.0,4,14,7,28,5,0,54,15
447,2470,8,2009/2010,2009-10-03 00:00:00,Wolverhampton Wanderers,Portsmouth,0,1,2.0,3.4,3.8,5,5,7,5,8,13,1,2,0,0,30,11,8,6,58.0,42.0,1,10,12,21,3,0,41,14
448,2474,8,2009/2010,2009-10-03 00:00:00,Burnley,Birmingham City,2,1,2.3,3.25,3.2,10,5,4,4,18,11,0,3,0,0,21,10,8,4,55.0,45.0,3,15,8,29,3,0,31,12
449,2475,8,2009/2010,2009-10-03 00:00:00,Bolton Wanderers,Tottenham Hotspur,2,2,3.8,3.6,1.95,10,7,5,6,15,16,2,1,0,0,30,31,5,6,53.0,47.0,4,17,11,31,3,0,61,11
450,2476,8,2009/2010,2009-10-03 00:00:00,Hull City,Wigan Athletic,2,1,2.88,3.3,2.5,4,4,6,9,10,9,0,2,0,0,8,13,4,2,50.0,50.0,3,8,15,19,2,0,21,6
451,2471,8,2009/2010,2009-10-04 00:00:00,West Ham United,Fulham,2,2,2.2,3.25,3.4,11,6,9,3,10,11,3,2,0,1,29,6,7,4,65.0,35.0,4,17,12,21,5,1,35,11
452,2472,8,2009/2010,2009-10-04 00:00:00,Everton,Stoke City,1,1,1.57,4.0,6.0,15,4,5,1,5,10,1,3,0,0,21,14,8,3,52.0,48.0,2,19,6,15,4,0,35,11
453,2473,8,2009/2010,2009-10-04 00:00:00,Chelsea,Liverpool,2,0,2.1,3.3,3.6,9,7,4,9,14,17,1,1,0,0,11,24,5,8,49.0,51.0,2,16,13,31,2,0,35,13
454,2478,8,2009/2010,2009-10-04 00:00:00,Arsenal,Blackburn Rovers,6,2,1.2,6.5,15.0,12,4,8,2,11,8,1,1,0,0,15,3,8,1,63.0,37.0,8,16,10,19,2,0,18,9
455,2477,8,2009/2010,2009-10-05 00:00:00,Aston Villa,Manchester City,1,1,2.75,3.25,2.63,6,7,7,3,12,9,1,2,0,0,10,19,6,6,50.0,50.0,2,13,10,21,3,0,29,12
456,2479,9,2009/2010,2009-10-17 00:00:00,Stoke City,West Ham United,2,1,2.1,3.3,3.6,3,10,7,2,18,14,3,3,0,0,26,33,5,6,50.0,50.0,3,13,9,32,6,0,59,11
457,2480,9,2009/2010,2009-10-17 00:00:00,Manchester United,Bolton Wanderers,2,1,1.2,5.5,13.0,8,10,7,8,14,9,0,1,0,0,27,11,12,1,52.0,48.0,3,18,15,23,1,0,38,13
458,2482,9,2009/2010,2009-10-17 00:00:00,Everton,Wolverhampton Wanderers,1,1,1.44,4.2,6.5,4,9,7,2,7,15,1,3,0,0,29,23,6,5,51.0,49.0,2,13,9,22,4,0,52,11
459,2484,9,2009/2010,2009-10-17 00:00:00,Aston Villa,Chelsea,2,1,4.5,3.6,1.8,2,13,4,7,20,12,2,1,0,0,24,17,6,9,43.0,57.0,3,15,11,32,3,0,41,15
460,2485,9,2009/2010,2009-10-17 00:00:00,Sunderland,Liverpool,1,0,4.2,3.4,1.91,6,7,7,12,20,14,2,1,0,0,16,21,1,7,51.0,49.0,1,13,19,34,3,0,37,8
461,2487,9,2009/2010,2009-10-17 00:00:00,Portsmouth,Tottenham Hotspur,1,2,4.5,3.5,1.83,9,3,10,7,14,13,3,3,0,1,38,16,10,8,55.0,45.0,3,12,17,27,6,1,54,18
462,2488,9,2009/2010,2009-10-17 00:00:00,Arsenal,Birmingham City,3,1,1.17,7.0,19.0,12,1,9,1,8,16,1,2,0,0,15,7,7,3,61.0,39.0,4,13,10,24,3,0,22,10
463,2483,9,2009/2010,2009-10-18 00:00:00,Blackburn Rovers,Burnley,3,2,1.73,3.6,5.0,4,3,4,4,15,14,3,3,0,0,11,11,3,2,52.0,48.0,5,7,8,29,6,0,22,5
464,2486,9,2009/2010,2009-10-18 00:00:00,Wigan Athletic,Manchester City,1,1,5.0,3.6,1.73,8,4,7,1,12,11,2,1,0,0,18,25,6,6,59.0,41.0,2,12,8,23,3,0,43,12
465,2481,9,2009/2010,2009-10-19 00:00:00,Fulham,Hull City,2,0,1.67,3.6,5.5,12,4,6,5,14,14,1,1,0,0,22,12,7,4,63.0,37.0,2,16,11,28,2,0,34,11
466,2119,10,2009/2010,2009-10-24 00:00:00,Burnley,Wigan Athletic,1,3,2.5,3.3,2.88,8,5,3,5,11,10,2,0,0,0,21,10,7,4,50.0,50.0,4,13,8,21,2,0,31,11
467,2120,10,2009/2010,2009-10-24 00:00:00,Chelsea,Blackburn Rovers,5,0,1.2,6.5,15.0,14,4,11,3,7,12,0,1,0,0,26,14,8,0,65.0,35.0,5,18,14,19,1,0,40,8
468,2122,10,2009/2010,2009-10-24 00:00:00,Birmingham City,Sunderland,2,1,2.9,3.25,2.5,11,6,6,7,7,11,3,1,0,0,15,29,6,8,47.0,53.0,3,17,13,18,4,0,44,14
469,2123,10,2009/2010,2009-10-24 00:00:00,Tottenham Hotspur,Stoke City,0,1,1.44,4.33,7.5,10,3,9,6,9,18,0,3,0,0,16,10,7,1,67.0,33.0,1,13,15,27,3,0,26,8
470,2125,10,2009/2010,2009-10-24 00:00:00,Wolverhampton Wanderers,Aston Villa,1,1,3.5,3.2,2.2,4,6,4,4,10,12,1,2,0,0,17,23,8,3,55.0,45.0,2,10,8,22,3,0,40,11
471,2126,10,2009/2010,2009-10-24 00:00:00,Hull City,Portsmouth,0,0,2.6,3.2,2.8,2,3,6,6,17,25,2,1,0,0,23,24,6,6,53.0,47.0,0,5,12,42,3,0,47,12
472,2121,10,2009/2010,2009-10-25 00:00:00,Bolton Wanderers,Everton,3,2,2.63,3.25,2.75,4,9,5,5,9,12,3,1,0,0,14,16,4,3,46.0,54.0,5,13,10,21,4,0,30,7
473,2124,10,2009/2010,2009-10-25 00:00:00,West Ham United,Arsenal,2,2,7.0,4.2,1.5,6,6,8,6,18,17,3,2,0,0,15,21,6,8,50.0,50.0,4,12,14,35,5,0,36,14
474,2127,10,2009/2010,2009-10-25 00:00:00,Liverpool,Manchester United,2,0,3.0,3.25,2.4,6,7,6,3,20,13,2,3,0,0,14,10,5,1,49.0,51.0,2,13,9,33,5,0,24,6
475,2128,10,2009/2010,2009-10-25 00:00:00,Manchester City,Fulham,2,2,1.44,4.2,8.0,8,2,14,7,13,11,0,2,0,0,30,8,13,2,49.0,51.0,4,10,21,24,2,0,38,15
476,2129,11,2009/2010,2009-10-31 00:00:00,Portsmouth,Wigan Athletic,4,0,2.38,3.3,3.0,8,4,9,4,12,10,0,1,0,0,26,11,7,4,54.0,46.0,4,12,13,22,1,0,37,11
477,2130,11,2009/2010,2009-10-31 00:00:00,Manchester United,Blackburn Rovers,2,0,1.17,7.0,19.0,9,2,10,2,7,13,0,2,0,0,35,4,7,2,65.0,35.0,2,11,12,20,2,0,39,9
478,2131,11,2009/2010,2009-10-31 00:00:00,Fulham,Liverpool,3,1,4.2,3.4,1.91,2,4,6,3,10,12,1,0,0,2,10,9,2,2,51.0,49.0,4,6,9,22,1,2,19,4
479,2132,11,2009/2010,2009-10-31 00:00:00,Everton,Aston Villa,1,1,2.5,3.25,2.88,3,6,7,8,21,18,1,3,1,0,27,22,3,4,46.0,54.0,2,9,15,39,4,1,49,7
480,2133,11,2009/2010,2009-10-31 00:00:00,Burnley,Hull City,2,0,1.91,3.4,4.2,4,4,7,3,10,12,1,3,0,0,20,7,7,1,60.0,40.0,2,8,10,22,4,0,27,8
481,2134,11,2009/2010,2009-10-31 00:00:00,Bolton Wanderers,Chelsea,0,4,9.0,4.33,1.4,6,15,9,12,9,7,1,1,1,0,14,14,8,9,48.0,52.0,4,21,21,16,2,1,28,17
482,2136,11,2009/2010,2009-10-31 00:00:00,Arsenal,Tottenham Hotspur,3,0,1.57,4.0,6.0,8,6,8,2,16,10,1,1,0,0,12,15,6,2,56.0,44.0,3,14,10,26,2,0,27,8
483,2137,11,2009/2010,2009-10-31 00:00:00,Stoke City,Wolverhampton Wanderers,2,2,1.91,3.4,4.2,4,5,6,4,12,14,0,3,0,0,24,18,4,3,52.0,48.0,4,9,10,26,3,0,42,7
484,2138,11,2009/2010,2009-10-31 00:00:00,Sunderland,West Ham United,2,2,2.0,3.3,4.0,5,6,10,5,13,10,3,3,1,0,30,10,8,2,50.0,50.0,4,11,15,23,6,1,40,10
485,2135,11,2009/2010,2009-11-01 00:00:00,Birmingham City,Manchester City,0,0,4.33,3.6,1.83,5,8,3,7,9,11,3,2,0,0,27,31,4,8,43.0,57.0,0,13,10,20,5,0,58,12
486,2221,2,2009/2010,2009-11-04 00:00:00,West Ham United,Aston Villa,2,1,2.75,3.3,2.63,9,9,7,4,11,16,2,4,0,0,11,26,6,14,55.0,45.0,3,18,11,27,6,0,37,20
487,2141,12,2009/2010,2009-11-07 00:00:00,Wolverhampton Wanderers,Arsenal,1,4,9.0,4.75,1.36,3,8,3,5,7,13,2,3,0,0,13,25,4,4,40.0,60.0,5,11,8,20,5,0,38,8
488,2143,12,2009/2010,2009-11-07 00:00:00,Tottenham Hotspur,Sunderland,2,0,1.57,3.75,6.5,4,8,5,7,9,17,1,2,0,0,10,22,4,4,51.0,49.0,2,12,12,26,3,0,32,8
489,2144,12,2009/2010,2009-11-07 00:00:00,Manchester City,Burnley,3,3,1.33,4.75,11.0,7,1,6,2,12,11,1,3,0,0,10,4,8,3,52.0,48.0,6,8,8,23,4,0,14,11
490,2146,12,2009/2010,2009-11-07 00:00:00,Aston Villa,Bolton Wanderers,5,1,1.8,3.5,4.75,8,7,11,4,14,19,1,4,0,0,33,19,8,1,60.0,40.0,6,15,15,33,5,0,52,9
491,2147,12,2009/2010,2009-11-07 00:00:00,Blackburn Rovers,Portsmouth,3,1,2.1,3.4,3.6,5,2,3,5,13,15,3,3,0,0,21,10,8,5,60.0,40.0,4,7,8,28,6,0,31,13
492,2139,12,2009/2010,2009-11-08 00:00:00,Wigan Athletic,Fulham,1,1,2.25,3.2,3.4,13,6,8,4,16,16,2,1,0,0,27,21,10,6,57.0,43.0,2,19,12,32,3,0,48,16
493,2140,12,2009/2010,2009-11-08 00:00:00,Hull City,Stoke City,2,1,2.75,3.3,2.6,3,3,8,3,13,13,1,4,0,0,10,13,4,2,53.0,47.0,3,6,11,26,5,0,23,6
494,2142,12,2009/2010,2009-11-08 00:00:00,West Ham United,Everton,1,2,2.4,3.3,3.0,8,4,11,4,13,18,0,5,0,0,34,15,5,4,54.0,46.0,3,12,15,31,5,0,49,9
495,2148,12,2009/2010,2009-11-08 00:00:00,Chelsea,Manchester United,1,0,2.0,3.25,4.0,6,8,3,11,12,15,3,3,0,0,12,19,0,7,52.0,48.0,1,14,14,27,6,0,31,7
496,2145,12,2009/2010,2009-11-09 00:00:00,Liverpool,Birmingham City,2,2,1.36,4.5,10.0,15,0,16,3,7,8,1,2,0,0,42,3,11,1,63.0,37.0,4,15,19,15,3,0,45,12
497,2149,13,2009/2010,2009-11-21 00:00:00,Birmingham City,Fulham,1,0,2.5,3.2,2.9,1,5,1,6,5,10,1,0,0,0,8,21,0,7,45.0,55.0,1,6,7,15,1,0,29,7
498,2150,13,2009/2010,2009-11-21 00:00:00,Sunderland,Arsenal,1,0,6.0,3.75,1.62,1,5,5,6,10,11,2,1,0,0,14,17,2,6,43.0,57.0,1,6,11,21,3,0,31,8
499,2152,13,2009/2010,2009-11-21 00:00:00,Burnley,Aston Villa,1,1,3.4,3.3,2.2,3,5,8,4,7,11,0,3,0,0,15,23,6,8,41.0,59.0,2,8,12,18,3,0,38,14
500,2153,13,2009/2010,2009-11-21 00:00:00,Chelsea,Wolverhampton Wanderers,4,0,1.17,7.0,19.0,12,4,10,2,5,14,0,2,0,0,13,11,5,6,70.0,30.0,4,16,12,19,2,0,24,11
501,2154,13,2009/2010,2009-11-21 00:00:00,Hull City,West Ham United,3,3,2.88,3.25,2.5,6,8,4,7,10,16,0,4,1,0,13,17,5,3,55.0,45.0,6,14,11,26,4,1,30,8
502,2155,13,2009/2010,2009-11-21 00:00:00,Liverpool,Manchester City,2,2,1.91,3.4,4.2,7,3,4,3,6,11,2,0,0,0,23,13,7,3,51.0,49.0,4,10,7,17,2,0,36,10
503,2156,13,2009/2010,2009-11-21 00:00:00,Manchester United,Everton,3,0,1.4,4.5,9.0,7,6,6,6,3,10,2,2,0,0,40,8,13,4,67.0,33.0,3,13,12,13,4,0,48,17
504,2151,13,2009/2010,2009-11-22 00:00:00,Stoke City,Portsmouth,1,0,2.1,3.4,3.5,3,10,6,6,14,11,1,2,0,0,22,14,4,4,53.0,47.0,1,13,12,25,3,0,36,8
505,2157,13,2009/2010,2009-11-22 00:00:00,Tottenham Hotspur,Wigan Athletic,9,1,1.44,4.33,8.0,7,4,12,7,9,11,1,0,0,0,25,4,10,5,58.0,42.0,10,11,19,20,1,0,29,15
506,2158,13,2009/2010,2009-11-22 00:00:00,Bolton Wanderers,Blackburn Rovers,0,2,2.25,3.2,3.4,7,8,7,3,13,10,3,1,0,0,18,17,7,6,41.0,59.0,2,15,10,23,4,0,35,13
507,2193,17,2009/2010,2009-11-25 00:00:00,Hull City,Everton,3,2,3.5,3.3,2.15,4,3,1,2,17,21,1,4,0,0,11,19,3,4,53.0,47.0,5,7,3,38,5,0,30,7
508,2222,2,2009/2010,2009-11-25 00:00:00,Fulham,Blackburn Rovers,3,0,2.1,3.3,3.6,0,3,4,4,9,13,0,0,0,0,11,8,1,3,45.0,55.0,3,3,8,22,0,0,19,4
509,2159,14,2009/2010,2009-11-28 00:00:00,Portsmouth,Manchester United,1,4,10.0,4.5,1.36,11,4,9,6,16,13,4,3,0,0,14,19,4,8,46.0,54.0,5,15,15,29,7,0,33,12
510,2160,14,2009/2010,2009-11-28 00:00:00,West Ham United,Burnley,5,3,1.8,3.6,4.5,3,9,4,6,9,10,2,1,0,1,5,16,1,7,50.0,50.0,8,12,10,19,3,1,21,8
511,2162,14,2009/2010,2009-11-28 00:00:00,Manchester City,Hull City,1,1,1.29,5.5,11.0,6,2,10,5,14,12,1,3,0,0,16,9,8,2,61.0,39.0,2,8,15,26,4,0,25,10
512,2163,14,2009/2010,2009-11-28 00:00:00,Fulham,Bolton Wanderers,1,1,1.91,3.5,4.2,10,2,5,2,10,16,1,6,0,0,22,20,7,6,50.0,50.0,2,12,7,26,7,0,42,13
513,2165,14,2009/2010,2009-11-28 00:00:00,Blackburn Rovers,Stoke City,0,0,1.91,3.4,4.2,5,5,6,4,12,12,1,2,0,0,16,1,9,2,53.0,47.0,0,10,10,24,3,0,17,11
514,2166,14,2009/2010,2009-11-28 00:00:00,Aston Villa,Tottenham Hotspur,1,1,2.5,3.25,2.88,2,18,9,6,9,10,0,1,0,0,19,28,7,8,49.0,51.0,2,20,15,19,1,0,47,15
515,2168,14,2009/2010,2009-11-28 00:00:00,Wigan Athletic,Sunderland,1,0,2.4,3.4,2.9,8,0,9,10,10,12,0,3,0,0,14,24,5,8,49.0,51.0,1,8,19,22,3,0,38,13
516,2161,14,2009/2010,2009-11-29 00:00:00,Wolverhampton Wanderers,Birmingham City,0,1,2.4,3.2,3.1,3,7,6,5,15,9,2,1,0,0,17,18,6,5,53.0,47.0,1,10,11,24,3,0,35,11
517,2164,14,2009/2010,2009-11-29 00:00:00,Everton,Liverpool,0,2,3.5,3.4,2.1,7,8,6,3,15,10,1,0,0,0,25,13,6,4,52.0,48.0,2,15,9,25,1,0,38,10
518,2167,14,2009/2010,2009-11-29 00:00:00,Arsenal,Chelsea,0,3,2.7,3.2,2.7,9,4,2,3,13,13,2,2,0,0,29,17,4,3,55.0,45.0,3,13,5,26,4,0,46,7
519,2169,15,2009/2010,2009-12-05 00:00:00,Portsmouth,Burnley,2,0,1.91,3.4,4.2,2,7,6,4,11,12,4,2,0,0,14,12,5,5,48.0,52.0,2,9,10,23,6,0,26,10
520,2170,15,2009/2010,2009-12-05 00:00:00,West Ham United,Manchester United,0,4,8.0,4.2,1.44,6,3,4,9,8,15,0,1,0,0,4,26,2,8,41.0,59.0,4,9,13,23,1,0,30,10
521,2171,15,2009/2010,2009-12-05 00:00:00,Wigan Athletic,Birmingham City,2,3,2.1,3.3,3.6,7,10,9,1,13,10,2,0,0,0,11,9,2,2,46.0,54.0,5,17,10,23,2,0,20,4
522,2172,15,2009/2010,2009-12-05 00:00:00,Wolverhampton Wanderers,Bolton Wanderers,2,1,2.38,3.25,3.1,7,8,4,7,13,15,2,1,0,0,34,26,11,10,55.0,45.0,3,15,11,28,3,0,60,21
523,2173,15,2009/2010,2009-12-05 00:00:00,Manchester City,Chelsea,2,1,4.2,3.4,1.91,8,6,6,5,12,15,1,6,0,0,25,21,9,6,53.0,47.0,3,14,11,27,7,0,46,15
524,2176,15,2009/2010,2009-12-05 00:00:00,Blackburn Rovers,Liverpool,0,0,5.25,3.8,1.67,3,11,5,5,15,9,1,0,0,0,7,12,1,8,43.0,57.0,0,14,10,24,1,0,19,9
525,2177,15,2009/2010,2009-12-05 00:00:00,Aston Villa,Hull City,3,0,1.44,4.33,7.5,6,2,6,5,15,12,4,3,0,0,22,9,9,3,52.0,48.0,3,8,11,27,7,0,31,12
526,2178,15,2009/2010,2009-12-05 00:00:00,Arsenal,Stoke City,2,0,1.29,5.0,13.0,7,4,3,0,3,7,0,0,0,0,25,13,10,2,61.0,39.0,2,11,3,10,0,0,38,12
527,2174,15,2009/2010,2009-12-06 00:00:00,Fulham,Sunderland,1,0,2.1,3.3,3.6,3,5,12,3,10,13,1,2,0,0,14,15,4,8,45.0,55.0,1,8,15,23,3,0,29,12
528,2175,15,2009/2010,2009-12-06 00:00:00,Everton,Tottenham Hotspur,2,2,2.88,3.25,2.5,5,8,9,10,13,19,4,4,0,0,24,27,1,6,48.0,52.0,4,13,19,32,8,0,51,7
529,2179,16,2009/2010,2009-12-12 00:00:00,Manchester United,Aston Villa,0,1,1.5,4.2,7.0,10,4,8,4,5,15,1,1,0,0,29,17,9,4,57.0,43.0,1,14,12,20,2,0,46,13
530,2180,16,2009/2010,2009-12-12 00:00:00,Stoke City,Wigan Athletic,2,2,2.1,3.3,3.6,6,7,9,3,19,10,5,1,0,0,22,8,5,3,51.0,49.0,4,13,12,29,6,0,30,8
531,2181,16,2009/2010,2009-12-12 00:00:00,Sunderland,Portsmouth,1,1,1.8,3.5,4.75,9,4,8,3,13,13,4,3,0,0,15,11,9,6,50.0,50.0,2,13,11,26,7,0,26,15
532,2182,16,2009/2010,2009-12-12 00:00:00,Tottenham Hotspur,Wolverhampton Wanderers,0,1,1.25,5.75,13.0,17,1,10,3,8,12,0,5,0,0,25,10,3,5,60.0,40.0,1,18,13,20,5,0,35,8
533,2184,16,2009/2010,2009-12-12 00:00:00,Hull City,Blackburn Rovers,0,0,2.8,3.25,2.6,8,9,1,5,12,16,1,2,0,0,15,16,3,4,47.0,53.0,0,17,6,28,3,0,31,7
534,2185,16,2009/2010,2009-12-12 00:00:00,Chelsea,Everton,3,3,1.25,5.5,15.0,11,6,12,4,13,18,0,1,0,0,38,10,7,1,51.0,49.0,6,17,16,31,1,0,48,8
535,2186,16,2009/2010,2009-12-12 00:00:00,Burnley,Fulham,1,1,2.63,3.25,2.75,8,4,1,5,12,8,0,2,0,0,21,18,7,4,37.0,63.0,2,12,6,20,2,0,39,11
536,2187,16,2009/2010,2009-12-12 00:00:00,Bolton Wanderers,Manchester City,3,3,4.5,3.6,1.8,7,6,4,8,12,12,3,2,0,0,20,29,5,9,33.0,67.0,6,13,12,24,5,0,49,14
537,2188,16,2009/2010,2009-12-12 00:00:00,Birmingham City,West Ham United,1,0,2.1,3.3,3.6,10,8,5,7,10,15,3,4,0,0,28,16,11,7,54.0,46.0,1,18,12,25,7,0,44,18
538,2183,16,2009/2010,2009-12-13 00:00:00,Liverpool,Arsenal,1,2,2.2,3.3,3.4,4,4,1,2,13,12,3,3,0,0,12,11,3,4,47.0,53.0,3,8,3,25,6,0,23,7
539,2190,17,2009/2010,2009-12-15 00:00:00,Sunderland,Aston Villa,0,2,2.88,3.3,2.5,7,2,9,7,16,15,2,2,0,0,15,4,7,1,48.0,52.0,2,9,16,31,4,0,19,8
540,2192,17,2009/2010,2009-12-15 00:00:00,Manchester United,Wolverhampton Wanderers,3,0,1.17,7.0,19.0,11,1,4,3,7,10,1,1,0,0,26,9,8,2,63.0,37.0,3,12,7,17,2,0,35,10
541,2195,17,2009/2010,2009-12-15 00:00:00,Bolton Wanderers,West Ham United,3,1,2.25,3.3,3.25,6,8,14,4,11,10,4,1,0,0,29,20,8,4,47.0,53.0,4,14,18,21,5,0,49,12
542,2196,17,2009/2010,2009-12-15 00:00:00,Birmingham City,Blackburn Rovers,2,1,2.2,3.25,3.4,5,6,7,6,10,17,2,2,0,0,12,23,6,7,49.0,51.0,3,11,13,27,4,0,35,13
543,2189,17,2009/2010,2009-12-16 00:00:00,Tottenham Hotspur,Manchester City,3,0,2.25,3.3,3.25,3,4,11,3,9,6,2,3,0,0,14,6,4,2,50.0,50.0,3,7,14,15,5,0,20,6
544,2194,17,2009/2010,2009-12-16 00:00:00,Burnley,Arsenal,1,1,7.0,4.2,1.5,3,10,5,8,10,11,2,0,0,0,21,28,3,6,49.0,51.0,2,13,13,21,2,0,49,9
545,2197,17,2009/2010,2009-12-16 00:00:00,Liverpool,Wigan Athletic,2,1,1.33,4.75,11.0,8,7,7,4,12,11,1,1,0,0,35,4,13,0,51.0,49.0,3,15,11,23,2,0,39,13
546,2198,17,2009/2010,2009-12-16 00:00:00,Chelsea,Portsmouth,2,1,1.14,8.0,19.0,10,2,13,4,10,11,0,0,0,0,30,6,11,2,57.0,43.0,3,12,17,21,0,0,36,13
547,2199,18,2009/2010,2009-12-19 00:00:00,Arsenal,Hull City,3,0,1.22,6.0,15.0,7,3,9,2,9,12,1,5,0,0,19,16,7,0,60.0,40.0,3,10,11,21,6,0,35,7
548,2203,18,2009/2010,2009-12-19 00:00:00,Portsmouth,Liverpool,2,0,5.5,4.0,1.62,4,2,7,5,8,13,3,3,0,1,22,20,8,9,48.0,52.0,2,6,12,21,6,1,42,17
549,2204,18,2009/2010,2009-12-19 00:00:00,Manchester City,Sunderland,4,3,1.53,4.0,7.0,3,4,6,3,14,7,2,2,0,1,8,10,5,4,49.0,51.0,7,7,9,21,4,1,18,9
550,2205,18,2009/2010,2009-12-19 00:00:00,Fulham,Manchester United,3,0,6.5,4.0,1.57,6,5,4,11,10,9,0,1,0,0,14,18,5,2,50.0,50.0,3,11,15,19,1,0,32,7
551,2207,18,2009/2010,2009-12-19 00:00:00,Blackburn Rovers,Tottenham Hotspur,0,2,3.3,3.4,2.2,10,2,4,3,8,10,0,1,0,0,16,10,5,0,51.0,49.0,2,12,7,18,1,0,26,5
552,2208,18,2009/2010,2009-12-19 00:00:00,Aston Villa,Stoke City,1,0,1.4,4.33,9.0,7,7,10,8,10,15,0,1,0,0,19,16,3,4,57.0,43.0,1,14,18,25,1,0,35,7
553,2200,18,2009/2010,2009-12-20 00:00:00,Wolverhampton Wanderers,Burnley,2,0,2.1,3.3,3.6,9,6,0,4,9,8,2,1,0,0,18,20,5,5,52.0,48.0,2,15,4,17,3,0,38,10
554,2202,18,2009/2010,2009-12-20 00:00:00,West Ham United,Chelsea,1,1,8.5,4.5,1.4,3,6,1,9,13,14,4,3,0,0,7,10,5,5,45.0,55.0,2,9,10,27,7,0,17,10
555,2206,18,2009/2010,2009-12-20 00:00:00,Everton,Birmingham City,1,1,1.83,3.5,4.5,8,3,15,2,6,10,0,3,0,0,28,13,6,4,48.0,52.0,2,11,17,16,3,0,41,10
556,2209,19,2009/2010,2009-12-26 00:00:00,Wigan Athletic,Blackburn Rovers,1,1,2.3,3.25,3.2,3,2,8,6,8,19,1,4,0,0,15,14,7,2,56.0,44.0,2,5,14,27,5,0,29,9
557,2210,19,2009/2010,2009-12-26 00:00:00,West Ham United,Portsmouth,2,0,2.1,3.3,3.6,7,7,8,4,9,21,0,3,0,0,13,19,6,4,54.0,46.0,2,14,12,30,3,0,32,10
558,2211,19,2009/2010,2009-12-26 00:00:00,Sunderland,Everton,1,1,2.38,3.3,3.0,4,4,3,6,11,12,1,3,0,0,9,20,3,10,36.0,64.0,2,8,9,23,4,0,29,13
559,2212,19,2009/2010,2009-12-26 00:00:00,Manchester City,Stoke City,2,0,1.44,4.33,7.5,4,4,7,4,10,9,0,2,0,0,22,18,7,6,67.0,33.0,2,8,11,19,2,0,40,13
560,2213,19,2009/2010,2009-12-26 00:00:00,Liverpool,Wolverhampton Wanderers,2,0,1.29,5.5,11.0,9,2,6,4,6,12,0,1,0,0,27,6,7,1,59.0,41.0,2,11,10,18,1,0,33,8
561,2215,19,2009/2010,2009-12-26 00:00:00,Fulham,Tottenham Hotspur,0,0,2.8,3.4,2.5,6,3,8,5,15,13,1,0,0,0,10,10,4,2,52.0,48.0,0,9,13,28,1,0,20,6
562,2216,19,2009/2010,2009-12-26 00:00:00,Burnley,Bolton Wanderers,1,1,2.38,3.3,3.0,6,4,10,6,11,18,0,0,0,0,22,15,8,2,57.0,43.0,2,10,16,29,0,0,37,10
563,2217,19,2009/2010,2009-12-26 00:00:00,Birmingham City,Chelsea,0,0,6.5,3.8,1.57,7,16,3,12,6,13,1,2,0,0,14,32,7,11,42.0,58.0,0,23,15,19,3,0,46,18
564,2214,19,2009/2010,2009-12-27 00:00:00,Hull City,Manchester United,1,3,8.0,4.2,1.4,5,9,7,6,14,18,0,2,0,0,13,25,5,6,58.0,42.0,4,14,13,32,2,0,38,11
565,2218,19,2009/2010,2009-12-27 00:00:00,Arsenal,Aston Villa,3,0,1.73,3.5,5.0,8,3,8,5,15,15,1,3,0,0,17,18,10,4,69.0,31.0,3,11,13,30,4,0,35,14
566,2229,20,2009/2010,2009-12-28 00:00:00,Wolverhampton Wanderers,Manchester City,0,3,4.5,3.6,1.8,4,4,7,6,13,12,3,2,0,0,21,11,8,3,49.0,51.0,3,8,13,25,5,0,32,11
567,2230,20,2009/2010,2009-12-28 00:00:00,Tottenham Hotspur,West Ham United,2,0,1.44,4.2,8.0,9,2,12,3,8,10,2,3,0,0,22,9,9,3,55.0,45.0,2,11,15,18,5,0,31,12
568,2231,20,2009/2010,2009-12-28 00:00:00,Stoke City,Birmingham City,0,1,2.4,3.25,3.0,8,7,8,3,13,8,2,3,0,0,30,11,10,6,51.0,49.0,1,15,11,21,5,0,41,16
569,2233,20,2009/2010,2009-12-28 00:00:00,Everton,Burnley,2,0,1.57,3.8,6.5,11,9,11,3,6,16,1,5,0,0,24,13,10,7,58.0,42.0,2,20,14,22,6,0,37,17
570,2234,20,2009/2010,2009-12-28 00:00:00,Chelsea,Fulham,2,1,1.36,4.5,10.0,11,3,7,0,10,10,1,1,0,0,29,14,10,6,57.0,43.0,3,14,7,20,2,0,43,16
571,2236,20,2009/2010,2009-12-28 00:00:00,Blackburn Rovers,Sunderland,2,2,2.1,3.3,3.6,7,8,12,3,7,20,1,4,0,0,22,16,4,4,55.0,45.0,4,15,15,27,5,0,38,8
572,2235,20,2009/2010,2009-12-29 00:00:00,Bolton Wanderers,Hull City,2,2,1.8,3.6,4.75,4,5,11,7,16,18,1,2,0,0,19,27,8,8,56.0,44.0,4,9,18,34,3,0,46,16
573,2237,20,2009/2010,2009-12-29 00:00:00,Aston Villa,Liverpool,0,1,2.8,3.25,2.6,5,8,4,5,13,10,1,1,0,0,32,23,8,10,49.0,51.0,1,13,9,23,2,0,55,18
574,2232,20,2009/2010,2009-12-30 00:00:00,Portsmouth,Arsenal,1,4,6.5,4.0,1.53,5,6,4,5,16,3,2,0,0,0,15,28,2,10,49.0,51.0,5,11,9,19,2,0,43,12
575,2238,20,2009/2010,2009-12-30 00:00:00,Manchester United,Wigan Athletic,5,0,1.2,6.5,15.0,9,5,8,6,6,11,0,1,0,0,38,7,7,3,65.0,35.0,5,14,14,17,1,0,45,10
576,2191,17,2009/2010,2010-01-05 00:00:00,Stoke City,Fulham,3,2,2.63,3.25,2.75,5,4,4,9,11,10,1,0,0,0,16,19,8,10,50.0,50.0,5,9,13,21,1,0,35,18
577,2247,21,2009/2010,2010-01-09 00:00:00,Birmingham City,Manchester United,1,1,6.5,3.6,1.62,5,13,2,5,10,12,2,1,0,0,11,39,2,12,33.0,67.0,2,18,7,22,3,0,50,14
578,2248,21,2009/2010,2010-01-09 00:00:00,Arsenal,Everton,2,2,1.4,4.5,8.5,5,5,0,2,9,7,1,1,0,0,33,23,4,7,52.0,48.0,4,10,2,16,2,0,56,11
579,2241,21,2009/2010,2010-01-11 00:00:00,Manchester City,Blackburn Rovers,4,1,1.44,4.33,8.0,2,2,7,7,6,8,1,1,0,0,16,17,4,3,58.0,42.0,5,4,14,14,2,0,33,7
580,2250,22,2009/2010,2010-01-16 00:00:00,Stoke City,Liverpool,1,1,3.5,3.2,2.2,3,4,4,2,13,12,1,2,0,0,31,13,10,0,49.0,51.0,2,7,6,25,3,0,44,10
581,2251,22,2009/2010,2010-01-16 00:00:00,Tottenham Hotspur,Hull City,0,0,1.25,6.0,11.0,17,2,8,3,14,10,4,2,0,0,32,6,10,0,51.0,49.0,0,19,11,24,6,0,38,10
582,2252,22,2009/2010,2010-01-16 00:00:00,Wolverhampton Wanderers,Wigan Athletic,0,2,2.3,3.25,3.2,6,12,8,6,16,16,4,3,0,0,25,12,4,3,44.0,56.0,2,18,14,32,7,0,37,7
583,2253,22,2009/2010,2010-01-16 00:00:00,Manchester United,Burnley,3,0,1.17,7.0,17.0,10,8,14,6,13,8,0,0,0,0,24,6,7,1,61.0,39.0,3,18,20,21,0,0,30,8
584,2254,22,2009/2010,2010-01-16 00:00:00,Everton,Manchester City,2,0,2.88,3.25,2.5,5,5,7,6,10,11,0,0,0,0,20,7,11,3,51.0,49.0,2,10,13,21,0,0,27,14
585,2255,22,2009/2010,2010-01-16 00:00:00,Chelsea,Sunderland,7,2,1.22,6.0,15.0,9,2,9,3,2,6,0,1,0,0,29,4,12,1,65.0,35.0,9,11,12,8,1,0,33,13
586,2256,22,2009/2010,2010-01-17 00:00:00,Bolton Wanderers,Arsenal,0,2,6.5,4.0,1.53,5,3,5,5,8,5,1,2,0,0,14,16,1,4,45.0,55.0,2,8,10,13,3,0,30,5
587,2257,22,2009/2010,2010-01-17 00:00:00,Blackburn Rovers,Fulham,2,0,2.4,3.25,3.0,3,9,2,7,12,9,1,3,0,0,16,37,3,6,45.0,55.0,2,12,9,21,4,0,53,9
588,2258,22,2009/2010,2010-01-17 00:00:00,Aston Villa,West Ham United,0,0,1.53,3.8,7.0,5,2,12,7,7,13,1,3,0,0,43,9,16,4,56.0,44.0,0,7,19,20,4,0,52,20
589,2219,2,2009/2010,2010-01-20 00:00:00,Arsenal,Bolton Wanderers,4,2,1.22,5.5,17.0,10,4,6,5,18,11,1,2,0,0,11,12,9,3,57.0,43.0,6,14,11,29,3,0,23,12
590,2242,21,2009/2010,2010-01-20 00:00:00,Liverpool,Tottenham Hotspur,2,0,2.4,3.25,3.0,5,8,8,2,11,18,2,3,0,0,13,11,2,3,53.0,47.0,2,13,10,29,5,0,24,5
591,2263,23,2009/2010,2010-01-23 00:00:00,Manchester United,Hull City,4,0,1.14,6.5,15.0,10,4,11,7,6,10,1,1,0,0,28,16,12,8,58.0,42.0,4,14,18,16,2,0,44,20
592,2259,23,2009/2010,2010-01-26 00:00:00,Wolverhampton Wanderers,Liverpool,0,0,5.5,3.6,1.67,4,3,3,4,9,10,0,1,0,0,12,27,0,7,50.0,50.0,0,7,7,19,1,0,39,7
593,2260,23,2009/2010,2010-01-26 00:00:00,Tottenham Hotspur,Fulham,2,0,1.57,3.75,6.5,5,5,3,3,10,9,1,1,0,0,27,7,11,3,49.0,51.0,2,10,6,19,2,0,34,14
594,2262,23,2009/2010,2010-01-26 00:00:00,Portsmouth,West Ham United,1,1,2.5,3.25,2.88,8,6,5,8,16,10,3,1,0,0,28,18,6,4,47.0,53.0,2,14,13,26,4,0,46,10
595,2264,23,2009/2010,2010-01-26 00:00:00,Bolton Wanderers,Burnley,1,0,1.8,3.6,4.5,7,2,7,7,12,11,3,2,0,0,24,16,4,7,46.0,54.0,1,9,14,23,5,0,40,11
596,2265,23,2009/2010,2010-01-27 00:00:00,Everton,Sunderland,2,0,1.67,3.6,5.5,4,3,3,3,3,15,0,1,0,0,8,14,2,8,55.0,45.0,2,7,6,18,1,0,22,10
597,2266,23,2009/2010,2010-01-27 00:00:00,Chelsea,Birmingham City,3,0,1.22,6.0,15.0,11,2,13,3,11,10,0,0,0,0,19,8,8,3,57.0,43.0,3,13,16,21,0,0,27,11
598,2267,23,2009/2010,2010-01-27 00:00:00,Blackburn Rovers,Wigan Athletic,2,1,1.95,3.4,4.0,2,4,5,5,20,8,3,1,0,0,18,12,5,6,51.0,49.0,3,6,10,28,4,0,30,11
599,2268,23,2009/2010,2010-01-27 00:00:00,Aston Villa,Arsenal,0,0,3.2,3.25,2.3,1,11,7,3,16,15,2,2,0,0,26,11,7,7,51.0,49.0,0,12,10,31,4,0,37,14
600,2269,24,2009/2010,2010-01-30 00:00:00,West Ham United,Blackburn Rovers,0,0,2.1,3.3,3.6,3,3,3,4,17,17,0,1,0,0,25,24,10,8,51.0,49.0,0,6,7,34,1,0,49,18
601,2270,24,2009/2010,2010-01-30 00:00:00,Wigan Athletic,Everton,0,1,3.0,3.3,2.38,3,4,8,3,10,12,0,2,0,0,17,23,4,6,48.0,52.0,1,7,11,22,2,0,40,10
602,2273,24,2009/2010,2010-01-30 00:00:00,Liverpool,Bolton Wanderers,2,0,1.44,4.33,7.5,13,4,6,5,9,10,1,3,0,0,32,20,11,3,57.0,43.0,2,17,11,19,4,0,52,14
603,2274,24,2009/2010,2010-01-30 00:00:00,Hull City,Wolverhampton Wanderers,2,2,2.25,3.25,3.25,3,4,4,8,16,11,2,0,0,0,30,25,4,6,48.0,52.0,4,7,12,27,2,0,55,10
604,2275,24,2009/2010,2010-01-30 00:00:00,Fulham,Aston Villa,0,2,2.7,3.2,2.7,11,5,10,4,9,15,0,2,0,0,27,29,9,3,,,2,16,14,24,2,0,56,12
605,2276,24,2009/2010,2010-01-30 00:00:00,Burnley,Chelsea,1,2,13.0,5.0,1.29,4,5,2,8,9,10,1,1,0,0,11,21,3,9,47.0,53.0,3,9,10,19,2,0,32,12
606,2278,24,2009/2010,2010-01-30 00:00:00,Birmingham City,Tottenham Hotspur,1,1,3.1,3.25,2.38,7,10,7,10,13,9,4,2,0,0,12,26,5,8,51.0,49.0,2,17,17,22,6,0,38,13
607,2272,24,2009/2010,2010-01-31 00:00:00,Manchester City,Portsmouth,2,0,1.29,5.0,13.0,5,4,5,7,6,11,1,3,0,0,18,16,10,7,58.0,42.0,2,9,12,17,4,0,34,17
608,2277,24,2009/2010,2010-01-31 00:00:00,Arsenal,Manchester United,1,3,2.6,3.25,2.8,2,3,10,5,5,8,1,0,0,0,17,19,8,4,55.0,45.0,4,5,15,13,1,0,36,12
609,2271,24,2009/2010,2010-02-01 00:00:00,Sunderland,Stoke City,0,0,2.0,3.4,3.8,4,3,1,2,7,15,2,3,0,0,28,16,6,3,52.0,48.0,0,7,3,22,5,0,44,9
610,2243,21,2009/2010,2010-02-02 00:00:00,Hull City,Chelsea,1,1,13.0,5.0,1.29,4,11,4,11,10,12,1,3,0,0,20,26,6,8,45.0,55.0,2,15,15,22,4,0,46,14
611,2244,21,2009/2010,2010-02-03 00:00:00,Fulham,Portsmouth,1,0,1.67,3.5,6.0,8,9,6,5,14,13,0,1,0,0,23,25,5,5,48.0,52.0,1,17,11,27,1,0,48,10
612,2279,25,2009/2010,2010-02-06 00:00:00,Manchester United,Portsmouth,5,0,1.13,8.5,23.0,7,5,12,2,7,12,1,4,0,0,29,3,12,1,60.0,40.0,5,12,14,19,5,0,32,13
613,2280,25,2009/2010,2010-02-06 00:00:00,Stoke City,Blackburn Rovers,3,0,2.3,3.1,3.4,3,4,4,3,10,13,2,3,0,0,20,12,8,7,55.0,45.0,3,7,7,23,5,0,32,15
614,2281,25,2009/2010,2010-02-06 00:00:00,Sunderland,Wigan Athletic,1,1,2.0,3.4,3.8,8,6,5,7,11,15,4,5,0,0,17,8,2,3,53.0,47.0,2,14,12,26,9,0,25,5
615,2282,25,2009/2010,2010-02-06 00:00:00,Tottenham Hotspur,Aston Villa,0,0,2.1,3.3,3.6,13,3,8,3,9,5,0,0,0,0,17,3,9,2,58.0,42.0,0,16,11,14,0,0,20,11
616,2283,25,2009/2010,2010-02-06 00:00:00,Burnley,West Ham United,2,1,2.6,3.25,2.8,1,10,5,9,16,14,2,1,0,0,22,27,3,5,50.0,50.0,3,11,14,30,3,0,49,8
617,2285,25,2009/2010,2010-02-06 00:00:00,Bolton Wanderers,Fulham,0,0,2.25,3.3,3.25,11,3,6,4,6,11,0,0,0,0,17,18,2,5,50.0,50.0,0,14,10,17,0,0,35,7
618,2286,25,2009/2010,2010-02-06 00:00:00,Hull City,Manchester City,2,1,5.5,3.4,1.73,3,7,4,5,13,14,2,4,0,0,5,12,4,8,52.0,48.0,3,10,9,27,6,0,17,12
619,2287,25,2009/2010,2010-02-06 00:00:00,Liverpool,Everton,1,0,1.83,3.5,4.33,4,5,8,3,11,22,3,3,1,0,20,21,8,8,54.0,46.0,1,9,11,33,6,1,41,16
620,2284,25,2009/2010,2010-02-07 00:00:00,Chelsea,Arsenal,2,0,1.8,3.6,4.5,2,7,4,6,13,15,2,2,0,0,11,26,4,8,45.0,55.0,2,9,10,28,4,0,37,12
621,2288,25,2009/2010,2010-02-07 00:00:00,Birmingham City,Wolverhampton Wanderers,2,1,1.8,3.4,5.0,9,6,6,7,10,14,5,3,0,0,19,7,9,4,55.0,45.0,3,15,13,24,8,0,26,13
622,2290,26,2009/2010,2010-02-09 00:00:00,Fulham,Burnley,3,0,1.73,3.5,5.25,9,2,3,5,5,7,1,0,0,0,11,5,5,2,50.0,50.0,3,11,8,12,1,0,16,7
623,2293,26,2009/2010,2010-02-09 00:00:00,Wigan Athletic,Stoke City,1,1,2.2,3.3,3.4,8,7,6,4,12,7,2,3,0,0,12,20,9,5,56.0,44.0,2,15,10,19,5,0,32,14
624,2294,26,2009/2010,2010-02-09 00:00:00,Portsmouth,Sunderland,1,1,2.4,3.25,3.0,7,3,7,6,9,17,3,1,1,1,31,18,8,3,48.0,52.0,2,10,13,26,4,2,49,11
625,2298,26,2009/2010,2010-02-09 00:00:00,Manchester City,Bolton Wanderers,2,0,1.44,4.2,8.0,2,5,5,7,7,18,0,2,0,0,19,16,5,4,53.0,47.0,2,7,12,25,2,0,35,9
626,2289,26,2009/2010,2010-02-10 00:00:00,Arsenal,Liverpool,1,0,2.1,3.3,3.6,4,6,6,4,21,13,3,2,0,0,13,14,3,6,49.0,51.0,1,10,10,34,5,0,27,9
627,2291,26,2009/2010,2010-02-10 00:00:00,West Ham United,Birmingham City,2,0,2.25,3.3,3.25,7,6,6,7,14,9,1,2,0,0,15,22,3,6,58.0,42.0,2,13,13,23,3,0,37,9
628,2292,26,2009/2010,2010-02-10 00:00:00,Wolverhampton Wanderers,Tottenham Hotspur,1,0,4.2,3.4,1.91,6,4,4,9,12,8,2,1,0,0,13,24,5,6,57.0,43.0,1,10,13,20,3,0,37,11
629,2295,26,2009/2010,2010-02-10 00:00:00,Blackburn Rovers,Hull City,1,0,1.83,3.5,4.5,8,3,7,3,14,14,1,3,0,1,18,6,6,6,55.0,45.0,1,11,10,28,4,1,24,12
630,2296,26,2009/2010,2010-02-10 00:00:00,Aston Villa,Manchester United,1,1,4.2,3.5,1.91,4,7,5,5,9,12,0,1,0,1,12,26,1,7,43.0,57.0,2,11,10,21,1,1,38,8
631,2297,26,2009/2010,2010-02-10 00:00:00,Everton,Chelsea,2,1,5.0,3.6,1.73,4,8,2,9,9,11,1,2,0,0,9,12,2,6,30.0,70.0,3,12,11,20,3,0,21,8
632,2261,23,2009/2010,2010-02-16 00:00:00,Stoke City,Manchester City,1,1,3.1,3.2,2.38,3,4,7,5,17,15,3,3,1,0,15,19,3,3,51.0,49.0,2,7,12,32,6,1,34,6
633,2201,18,2009/2010,2010-02-17 00:00:00,Wigan Athletic,Bolton Wanderers,0,0,2.3,3.25,3.2,3,0,6,9,7,9,0,1,0,0,11,21,3,9,54.0,46.0,0,3,15,16,1,0,32,12
634,2300,27,2009/2010,2010-02-20 00:00:00,Portsmouth,Stoke City,1,2,2.38,3.25,3.1,5,3,4,8,7,10,2,1,0,0,23,19,7,6,54.0,46.0,3,8,12,17,3,0,42,13
635,2301,27,2009/2010,2010-02-20 00:00:00,West Ham United,Hull City,3,0,1.75,3.6,4.75,8,3,8,4,10,11,1,1,0,0,20,9,8,2,53.0,47.0,3,11,12,21,2,0,29,10
636,2303,27,2009/2010,2010-02-20 00:00:00,Everton,Manchester United,3,1,4.5,3.6,1.8,4,2,3,8,12,11,5,1,0,0,26,31,4,12,51.0,49.0,4,6,11,23,6,0,57,16
637,2304,27,2009/2010,2010-02-20 00:00:00,Arsenal,Sunderland,2,0,1.22,6.0,15.0,11,4,11,3,9,9,1,5,0,0,30,7,7,1,64.0,36.0,2,15,14,18,6,0,37,8
638,2306,27,2009/2010,2010-02-20 00:00:00,Wolverhampton Wanderers,Chelsea,0,2,12.0,5.0,1.3,8,1,4,6,12,15,0,1,0,0,17,14,1,5,42.0,58.0,2,9,10,27,1,0,31,6
639,2299,27,2009/2010,2010-02-21 00:00:00,Fulham,Birmingham City,2,1,2.1,3.25,3.75,5,7,6,3,9,15,1,1,0,0,15,13,3,1,52.0,48.0,3,12,9,24,2,0,28,4
640,2302,27,2009/2010,2010-02-21 00:00:00,Blackburn Rovers,Bolton Wanderers,3,0,1.95,3.25,4.33,4,8,7,3,14,12,0,1,0,0,23,17,8,2,60.0,40.0,3,12,10,26,1,0,40,10
641,2305,27,2009/2010,2010-02-21 00:00:00,Wigan Athletic,Tottenham Hotspur,0,3,3.75,3.5,2.0,6,9,2,1,15,12,3,4,0,0,8,7,3,2,48.0,52.0,3,15,3,27,7,0,15,5
642,2307,27,2009/2010,2010-02-21 00:00:00,Manchester City,Liverpool,0,0,2.4,3.3,3.0,3,1,3,4,6,15,1,6,0,0,18,14,8,6,49.0,51.0,0,4,7,21,7,0,32,14
643,2308,27,2009/2010,2010-02-21 00:00:00,Aston Villa,Burnley,5,2,1.36,4.5,10.0,4,5,7,4,5,10,0,3,0,0,22,8,9,3,52.0,48.0,7,9,11,15,3,0,30,12
644,2312,28,2009/2010,2010-02-23 00:00:00,Manchester United,West Ham United,3,0,1.2,6.5,15.0,8,8,3,6,13,12,0,1,0,0,26,26,6,7,60.0,40.0,3,16,9,25,1,0,52,13
645,2311,28,2009/2010,2010-02-27 00:00:00,Stoke City,Arsenal,1,3,5.0,3.6,1.73,4,10,2,6,13,7,0,1,1,0,17,17,3,5,41.0,59.0,4,14,8,20,1,1,34,8
646,2315,28,2009/2010,2010-02-27 00:00:00,Chelsea,Manchester City,2,4,1.44,4.33,7.5,15,4,6,3,17,13,3,1,1,0,62,12,3,2,51.0,49.0,6,19,9,30,4,1,74,5
647,2316,28,2009/2010,2010-02-27 00:00:00,Birmingham City,Wigan Athletic,1,0,1.91,3.3,4.33,4,5,5,6,9,15,1,3,0,0,8,16,2,7,50.0,50.0,1,9,11,24,4,0,24,9
648,2317,28,2009/2010,2010-02-27 00:00:00,Burnley,Portsmouth,1,2,2.0,3.4,3.8,6,2,7,7,9,13,1,2,0,0,20,16,4,3,49.0,51.0,3,8,14,22,3,0,36,7
649,2318,28,2009/2010,2010-02-27 00:00:00,Bolton Wanderers,Wolverhampton Wanderers,1,0,2.0,3.3,4.0,8,4,7,3,10,6,0,2,0,0,16,15,7,11,53.0,47.0,1,12,10,16,2,0,31,18
650,2309,28,2009/2010,2010-02-28 00:00:00,Sunderland,Fulham,0,0,2.2,3.2,3.5,5,1,6,3,17,14,3,3,0,0,16,6,2,2,49.0,51.0,0,6,9,31,6,0,22,4
651,2310,28,2009/2010,2010-02-28 00:00:00,Tottenham Hotspur,Everton,2,1,2.0,3.4,4.0,7,4,2,4,4,13,1,4,0,0,10,12,6,6,35.0,65.0,3,11,6,17,5,0,22,12
652,2313,28,2009/2010,2010-02-28 00:00:00,Liverpool,Blackburn Rovers,2,1,1.36,4.75,9.0,0,5,5,2,6,14,1,5,0,0,6,7,3,3,45.0,55.0,3,5,7,20,6,0,13,6
653,2320,29,2009/2010,2010-03-06 00:00:00,West Ham United,Bolton Wanderers,1,2,1.8,3.5,4.5,9,6,12,8,13,24,2,5,0,0,22,20,6,3,56.0,44.0,3,15,20,37,7,0,42,9
654,2326,29,2009/2010,2010-03-06 00:00:00,Arsenal,Burnley,3,1,1.14,7.5,21.0,11,4,10,3,7,11,0,4,0,0,29,5,8,2,65.0,35.0,4,15,13,18,4,0,34,10
655,2327,29,2009/2010,2010-03-06 00:00:00,Wolverhampton Wanderers,Manchester United,0,1,10.0,5.0,1.33,7,4,6,7,10,7,2,1,0,0,13,18,2,3,43.0,57.0,1,11,13,17,3,0,31,5
656,2323,29,2009/2010,2010-03-07 00:00:00,Everton,Hull City,5,1,1.36,4.5,10.0,6,2,5,2,3,13,0,1,0,0,22,8,2,1,52.0,48.0,6,8,7,16,1,0,30,3
657,2319,29,2009/2010,2010-03-08 00:00:00,Wigan Athletic,Liverpool,1,0,6.5,3.8,1.57,5,3,6,7,14,13,1,5,0,0,11,18,4,7,50.0,50.0,1,8,13,27,6,0,29,11
658,2246,21,2009/2010,2010-03-09 00:00:00,Sunderland,Bolton Wanderers,4,0,2.1,3.25,3.75,4,6,5,6,13,10,2,2,0,0,8,16,2,7,53.0,47.0,4,10,11,23,4,0,24,9
659,2249,22,2009/2010,2010-03-09 00:00:00,Portsmouth,Birmingham City,1,2,2.38,3.25,3.1,6,4,4,3,6,8,1,2,0,0,12,7,6,5,51.0,49.0,3,10,7,14,3,0,19,11
660,2245,21,2009/2010,2010-03-10 00:00:00,Burnley,Stoke City,1,1,2.5,3.3,2.88,4,3,5,6,12,10,2,0,0,0,15,20,4,4,51.0,49.0,2,7,11,22,2,0,35,8
661,2339,30,2009/2010,2010-03-13 00:00:00,Tottenham Hotspur,Blackburn Rovers,3,1,1.44,4.33,7.5,4,8,7,3,9,7,0,0,0,0,26,15,4,6,51.0,49.0,4,12,10,16,0,0,41,10
662,2341,30,2009/2010,2010-03-13 00:00:00,Stoke City,Aston Villa,0,0,3.3,3.25,2.25,5,4,5,7,3,5,0,4,0,0,25,12,8,6,41.0,59.0,0,9,12,8,4,0,37,14
663,2344,30,2009/2010,2010-03-13 00:00:00,Hull City,Arsenal,1,2,7.5,4.5,1.4,2,7,5,10,16,13,2,2,0,0,9,27,2,8,40.0,60.0,3,9,15,29,4,0,36,10
664,2345,30,2009/2010,2010-03-13 00:00:00,Birmingham City,Everton,2,2,3.0,3.25,2.4,4,6,5,2,14,11,1,1,0,0,19,18,5,4,53.0,47.0,4,10,7,25,2,0,37,9
665,2346,30,2009/2010,2010-03-13 00:00:00,Bolton Wanderers,Wigan Athletic,4,0,2.1,3.3,3.6,4,6,3,8,21,15,1,2,0,0,12,30,3,6,48.0,52.0,4,10,11,36,3,0,42,9
666,2347,30,2009/2010,2010-03-13 00:00:00,Burnley,Wolverhampton Wanderers,1,2,2.25,3.3,3.3,11,4,7,1,9,22,1,4,0,0,22,13,11,5,63.0,37.0,3,15,8,31,5,0,35,16
667,2348,30,2009/2010,2010-03-13 00:00:00,Chelsea,West Ham United,4,1,1.22,6.0,15.0,12,3,13,3,14,11,0,1,0,0,34,8,11,1,59.0,41.0,5,15,16,25,1,0,42,12
668,2340,30,2009/2010,2010-03-14 00:00:00,Sunderland,Manchester City,1,1,3.6,3.4,2.1,8,13,6,5,12,12,2,4,0,0,9,20,3,7,49.0,51.0,2,21,11,24,6,0,29,10
669,2342,30,2009/2010,2010-03-14 00:00:00,Manchester United,Fulham,3,0,1.22,6.0,15.0,16,5,15,3,7,10,1,1,0,0,33,5,11,1,68.0,32.0,3,21,18,17,2,0,38,12
670,2343,30,2009/2010,2010-03-15 00:00:00,Liverpool,Portsmouth,4,1,1.25,5.5,13.0,8,2,12,4,10,16,0,2,0,0,19,9,8,4,60.0,40.0,5,10,16,26,2,0,28,12
671,2239,21,2009/2010,2010-03-16 00:00:00,Wigan Athletic,Aston Villa,1,2,3.6,3.3,2.1,6,9,6,8,10,18,2,1,0,0,10,14,7,8,57.0,43.0,3,15,14,28,3,0,24,15
672,2349,31,2009/2010,2010-03-20 00:00:00,Wigan Athletic,Burnley,1,0,1.73,3.6,5.0,11,6,7,4,6,9,1,3,0,0,24,11,5,3,53.0,47.0,1,17,11,15,4,0,35,8
673,2350,31,2009/2010,2010-03-20 00:00:00,Sunderland,Birmingham City,3,1,2.2,3.2,3.5,7,11,4,9,9,9,0,1,0,0,18,17,7,10,53.0,47.0,4,18,13,18,1,0,35,17
674,2351,31,2009/2010,2010-03-20 00:00:00,Arsenal,West Ham United,2,0,1.25,5.75,13.0,4,4,5,5,9,25,1,4,1,0,13,6,4,2,53.0,47.0,2,8,10,34,5,1,19,6
675,2352,31,2009/2010,2010-03-20 00:00:00,Aston Villa,Wolverhampton Wanderers,2,2,1.4,4.33,9.0,8,4,11,4,7,7,1,2,0,0,53,27,6,5,54.0,46.0,4,12,15,14,3,0,80,11
676,2354,31,2009/2010,2010-03-20 00:00:00,Portsmouth,Hull City,3,2,2.2,3.2,3.5,5,1,8,5,7,9,1,1,0,0,33,24,11,1,56.0,44.0,5,6,13,16,2,0,57,12
677,2355,31,2009/2010,2010-03-20 00:00:00,Everton,Bolton Wanderers,2,0,1.53,3.8,7.0,11,4,6,2,15,17,1,1,0,1,15,5,5,3,65.0,35.0,2,15,8,32,2,1,20,8
678,2358,31,2009/2010,2010-03-20 00:00:00,Stoke City,Tottenham Hotspur,1,2,3.6,3.3,2.1,4,7,4,9,7,7,2,2,0,0,26,23,6,7,45.0,55.0,3,11,13,14,4,0,49,13
679,2353,31,2009/2010,2010-03-21 00:00:00,Blackburn Rovers,Chelsea,1,1,7.5,4.33,1.44,2,8,4,8,12,11,0,1,0,0,15,26,3,11,43.0,57.0,2,10,12,23,1,0,41,14
680,2356,31,2009/2010,2010-03-21 00:00:00,Fulham,Manchester City,1,2,3.1,3.25,2.38,4,5,4,6,7,7,0,0,0,0,22,6,4,2,49.0,51.0,3,9,10,14,0,0,28,6
681,2357,31,2009/2010,2010-03-21 00:00:00,Manchester United,Liverpool,2,1,1.67,3.75,5.5,4,1,5,1,10,16,2,3,0,0,13,11,1,2,60.0,40.0,3,5,6,26,5,0,24,3
682,2240,21,2009/2010,2010-03-23 00:00:00,West Ham United,Wolverhampton Wanderers,1,3,1.8,3.6,4.5,8,0,4,1,5,6,0,2,0,0,14,6,7,4,60.0,40.0,4,8,5,11,2,0,20,11
683,2228,2,2009/2010,2010-03-24 00:00:00,Manchester City,Everton,0,2,1.83,3.5,4.33,10,4,6,4,12,12,3,2,0,0,31,15,7,4,57.0,43.0,2,14,10,24,5,0,46,11
684,2322,29,2009/2010,2010-03-24 00:00:00,Portsmouth,Chelsea,0,5,12.0,5.0,1.3,3,6,6,8,11,13,3,2,0,0,10,16,1,6,39.0,61.0,5,9,14,24,5,0,26,7
685,2324,29,2009/2010,2010-03-24 00:00:00,Blackburn Rovers,Birmingham City,2,1,2.0,3.25,4.0,2,2,3,3,15,9,2,1,0,0,23,18,5,6,50.0,50.0,3,4,6,24,3,0,41,11
686,2325,29,2009/2010,2010-03-24 00:00:00,Aston Villa,Sunderland,1,1,1.53,3.8,7.0,7,3,10,6,10,7,0,0,0,0,24,11,6,7,49.0,51.0,2,10,16,17,0,0,35,13
687,2361,32,2009/2010,2010-03-27 00:00:00,Tottenham Hotspur,Portsmouth,2,0,1.2,6.0,17.0,7,4,8,4,6,8,0,1,0,0,40,16,11,2,55.0,45.0,2,11,12,14,1,0,56,13
688,2362,32,2009/2010,2010-03-27 00:00:00,Bolton Wanderers,Manchester United,0,4,8.5,4.5,1.4,12,4,3,5,10,12,0,0,0,0,17,20,11,6,45.0,55.0,4,16,8,22,0,0,37,17
689,2363,32,2009/2010,2010-03-27 00:00:00,West Ham United,Stoke City,0,1,2.1,3.3,3.6,12,6,8,7,15,14,0,2,0,0,13,22,6,6,53.0,47.0,1,18,15,29,2,0,35,12
690,2364,32,2009/2010,2010-03-27 00:00:00,Wolverhampton Wanderers,Everton,0,0,3.8,3.4,2.0,2,12,7,8,15,12,1,1,0,0,8,17,3,7,48.0,52.0,0,14,15,27,2,0,25,10
691,2365,32,2009/2010,2010-03-27 00:00:00,Hull City,Fulham,2,0,2.4,3.25,3.0,3,8,2,4,9,13,2,4,0,0,18,25,6,8,47.0,53.0,2,11,6,22,6,0,43,14
692,2366,32,2009/2010,2010-03-27 00:00:00,Chelsea,Aston Villa,7,1,1.4,4.75,8.0,5,2,2,1,8,5,3,2,0,0,15,8,8,5,50.0,50.0,8,7,3,13,5,0,23,13
693,2368,32,2009/2010,2010-03-27 00:00:00,Birmingham City,Arsenal,1,1,7.0,4.2,1.5,3,8,5,5,14,13,3,2,0,0,8,27,2,7,46.0,54.0,2,11,10,27,5,0,35,9
694,2359,32,2009/2010,2010-03-28 00:00:00,Liverpool,Sunderland,3,0,1.3,5.25,11.0,15,2,10,5,11,9,0,1,0,0,22,4,9,2,51.0,49.0,3,17,15,20,1,0,26,11
695,2367,32,2009/2010,2010-03-28 00:00:00,Burnley,Blackburn Rovers,0,1,2.5,3.25,2.88,1,5,5,7,15,14,3,2,0,0,20,13,7,2,49.0,51.0,1,6,12,29,5,0,33,9
696,2360,32,2009/2010,2010-03-29 00:00:00,Manchester City,Wigan Athletic,3,0,1.33,4.75,11.0,6,4,2,7,13,11,3,2,0,1,26,11,2,4,50.0,50.0,3,10,9,24,5,1,37,6
697,2369,33,2009/2010,2010-04-03 00:00:00,Sunderland,Tottenham Hotspur,3,1,3.6,3.3,2.1,10,9,2,3,16,17,2,0,0,0,9,13,6,6,52.0,48.0,4,19,5,33,2,0,22,12
698,2370,33,2009/2010,2010-04-03 00:00:00,Stoke City,Hull City,2,0,1.8,3.5,4.5,2,3,5,1,11,11,3,2,0,0,25,19,2,2,51.0,49.0,2,5,6,22,5,0,44,4
699,2371,33,2009/2010,2010-04-03 00:00:00,Portsmouth,Blackburn Rovers,0,0,3.3,3.3,2.25,4,8,4,8,12,6,2,1,0,0,10,31,2,8,47.0,53.0,0,12,12,18,3,0,41,10
700,2372,33,2009/2010,2010-04-03 00:00:00,Manchester United,Chelsea,1,2,2.63,3.2,2.75,3,3,6,5,13,11,3,2,0,0,22,11,2,3,56.0,44.0,3,6,11,24,5,0,33,5
701,2375,33,2009/2010,2010-04-03 00:00:00,Burnley,Manchester City,1,6,5.0,3.8,1.7,7,5,6,9,4,6,0,0,0,0,18,16,6,6,29.0,71.0,7,12,15,10,0,0,34,12
702,2376,33,2009/2010,2010-04-03 00:00:00,Bolton Wanderers,Aston Villa,0,1,2.88,3.25,2.5,6,8,5,4,9,9,2,0,0,0,13,14,5,7,45.0,55.0,1,14,9,18,2,0,27,12
703,2378,33,2009/2010,2010-04-03 00:00:00,Arsenal,Wolverhampton Wanderers,1,0,1.22,6.0,15.0,12,4,10,1,10,9,0,2,0,1,38,8,10,4,61.0,39.0,1,16,11,19,2,1,46,14
704,2373,33,2009/2010,2010-04-04 00:00:00,Fulham,Wigan Athletic,2,1,2.0,3.4,3.8,3,7,3,4,9,7,1,2,0,0,17,19,6,3,56.0,44.0,3,10,7,16,3,0,36,9
705,2374,33,2009/2010,2010-04-04 00:00:00,Everton,West Ham United,2,2,1.44,4.33,7.5,4,3,6,6,7,18,2,3,0,0,17,19,2,8,53.0,47.0,4,7,12,25,5,0,36,10
706,2377,33,2009/2010,2010-04-04 00:00:00,Birmingham City,Liverpool,1,1,4.5,3.5,1.83,3,10,4,8,12,8,2,1,0,0,19,27,5,4,49.0,51.0,2,13,12,20,3,0,46,9
707,2379,34,2009/2010,2010-04-10 00:00:00,West Ham United,Sunderland,1,0,2.0,3.4,3.8,7,4,4,4,14,18,1,3,0,0,10,17,3,6,50.0,50.0,1,11,8,32,4,0,27,9
708,2385,34,2009/2010,2010-04-10 00:00:00,Hull City,Burnley,1,4,1.73,3.6,5.0,4,3,6,3,11,13,5,1,0,0,24,13,6,1,46.0,54.0,5,7,9,24,6,0,37,7
709,2380,34,2009/2010,2010-04-11 00:00:00,Wolverhampton Wanderers,Stoke City,0,0,2.3,3.25,3.2,7,4,3,10,7,4,0,0,0,0,24,46,7,6,45.0,55.0,0,11,13,11,0,0,70,13
710,2383,34,2009/2010,2010-04-11 00:00:00,Manchester City,Birmingham City,5,1,1.4,4.5,8.5,6,2,11,3,13,9,0,3,0,0,17,11,8,4,59.0,41.0,6,8,14,22,3,0,28,12
711,2384,34,2009/2010,2010-04-11 00:00:00,Liverpool,Fulham,0,0,1.29,5.0,13.0,11,2,10,0,8,17,1,3,0,0,40,6,10,1,61.0,39.0,0,13,10,25,4,0,46,11
712,2387,34,2009/2010,2010-04-11 00:00:00,Blackburn Rovers,Manchester United,0,0,6.5,4.0,1.53,7,7,2,8,13,13,1,2,0,0,8,21,1,7,44.0,56.0,0,14,10,26,3,0,29,8
713,2386,34,2009/2010,2010-04-13 00:00:00,Chelsea,Bolton Wanderers,1,0,1.14,8.0,19.0,9,4,10,7,13,24,1,4,0,0,13,19,5,2,58.0,42.0,1,13,17,37,5,0,32,7
714,2381,34,2009/2010,2010-04-14 00:00:00,Wigan Athletic,Portsmouth,0,0,1.57,3.8,6.5,11,2,11,4,16,10,2,1,0,0,20,6,9,3,56.0,44.0,0,13,15,26,3,0,26,12
715,2382,34,2009/2010,2010-04-14 00:00:00,Tottenham Hotspur,Arsenal,2,1,3.25,3.3,2.25,9,10,2,7,10,8,3,1,0,0,16,31,4,6,37.0,63.0,3,19,9,18,4,0,47,10
716,2388,34,2009/2010,2010-04-14 00:00:00,Aston Villa,Everton,2,2,2.25,3.3,3.3,4,7,7,3,11,8,2,2,0,0,36,21,7,7,49.0,51.0,4,11,10,19,4,0,57,14
717,2390,35,2009/2010,2010-04-17 00:00:00,Tottenham Hotspur,Chelsea,2,1,4.0,3.6,1.91,12,8,9,4,8,16,2,4,0,0,25,15,13,4,57.0,43.0,3,20,13,24,6,0,40,17
718,2391,35,2009/2010,2010-04-17 00:00:00,Sunderland,Burnley,2,1,1.62,3.75,6.0,7,2,5,4,8,12,3,2,0,0,20,6,3,1,58.0,42.0,3,9,9,20,5,0,26,4
719,2392,35,2009/2010,2010-04-17 00:00:00,Stoke City,Bolton Wanderers,1,2,2.1,3.25,3.75,4,5,7,6,9,4,1,2,0,0,25,6,5,1,56.0,44.0,3,9,13,13,3,0,31,6
720,2395,35,2009/2010,2010-04-17 00:00:00,Fulham,Wolverhampton Wanderers,0,0,2.1,3.25,3.75,2,0,11,6,9,8,1,0,0,0,24,22,5,9,54.0,46.0,0,2,17,17,1,0,46,14
721,2396,35,2009/2010,2010-04-17 00:00:00,Blackburn Rovers,Everton,2,3,2.8,3.25,2.6,10,2,4,6,15,12,3,2,0,0,22,27,4,2,41.0,59.0,5,12,10,27,5,0,49,6
722,2397,35,2009/2010,2010-04-17 00:00:00,Birmingham City,Hull City,0,0,1.73,3.6,5.0,5,4,5,6,10,13,0,0,0,0,14,10,8,1,51.0,49.0,0,9,11,23,0,0,24,9
723,2398,35,2009/2010,2010-04-17 00:00:00,Manchester City,Manchester United,0,1,2.88,3.5,2.4,4,5,4,8,8,12,2,1,0,0,23,30,7,5,47.0,53.0,1,9,12,20,3,0,53,12
724,2389,35,2009/2010,2010-04-18 00:00:00,Wigan Athletic,Arsenal,3,2,6.5,4.0,1.53,10,7,6,3,13,16,2,1,0,0,14,3,8,3,46.0,54.0,5,17,9,29,3,0,17,11
725,2393,35,2009/2010,2010-04-18 00:00:00,Portsmouth,Aston Villa,1,2,5.5,3.75,1.67,10,6,6,3,5,12,0,0,0,0,17,34,7,6,45.0,55.0,3,16,9,17,0,0,51,13
726,2394,35,2009/2010,2010-04-19 00:00:00,Liverpool,West Ham United,3,0,1.33,5.0,10.0,9,2,8,3,7,12,0,2,0,0,29,14,9,2,65.0,35.0,3,11,11,19,2,0,43,11
727,2314,28,2009/2010,2010-04-21 00:00:00,Hull City,Aston Villa,0,2,3.5,3.4,2.1,5,4,6,5,8,7,2,2,0,0,18,16,10,9,46.0,54.0,2,9,11,15,4,0,34,19
728,2400,36,2009/2010,2010-04-24 00:00:00,Hull City,Sunderland,0,1,2.38,3.4,3.0,6,3,3,5,10,14,1,3,1,1,21,23,3,6,51.0,49.0,1,9,8,24,4,2,44,9
729,2401,36,2009/2010,2010-04-24 00:00:00,Wolverhampton Wanderers,Blackburn Rovers,1,1,2.2,3.25,3.4,5,6,8,3,10,11,0,1,0,0,18,15,4,4,52.0,48.0,2,11,11,21,1,0,33,8
730,2402,36,2009/2010,2010-04-24 00:00:00,West Ham United,Wigan Athletic,3,2,1.83,3.6,4.33,2,6,4,6,10,12,1,2,0,0,14,19,4,5,48.0,52.0,5,8,10,22,3,0,33,9
731,2403,36,2009/2010,2010-04-24 00:00:00,Manchester United,Tottenham Hotspur,3,1,1.5,4.2,7.0,7,2,7,6,15,11,1,0,0,0,29,17,4,4,58.0,42.0,4,9,13,26,1,0,46,8
732,2406,36,2009/2010,2010-04-24 00:00:00,Bolton Wanderers,Portsmouth,2,2,1.53,4.0,6.5,7,3,6,8,17,13,1,1,0,0,31,10,11,5,54.0,46.0,4,10,14,30,2,0,41,16
733,2408,36,2009/2010,2010-04-24 00:00:00,Arsenal,Manchester City,0,0,2.0,3.5,3.75,4,2,6,1,13,14,4,2,0,0,7,3,5,1,53.0,47.0,0,6,7,27,6,0,10,6
734,2399,36,2009/2010,2010-04-25 00:00:00,Everton,Fulham,2,1,1.36,4.5,10.0,7,4,6,3,6,7,0,1,0,0,41,8,10,2,56.0,44.0,3,11,9,13,1,0,49,12
735,2404,36,2009/2010,2010-04-25 00:00:00,Chelsea,Stoke City,7,0,1.14,8.0,21.0,12,2,12,1,12,11,0,3,0,0,25,8,6,0,64.0,36.0,7,14,13,23,3,0,33,6
736,2405,36,2009/2010,2010-04-25 00:00:00,Burnley,Liverpool,0,4,5.5,4.0,1.62,7,6,7,2,12,12,2,1,0,0,13,8,4,5,48.0,52.0,4,13,9,24,3,0,21,9
737,2407,36,2009/2010,2010-04-25 00:00:00,Aston Villa,Birmingham City,1,0,1.62,3.75,6.0,7,10,5,5,12,13,1,4,0,0,13,11,6,5,52.0,48.0,1,17,10,25,5,0,24,11
738,2410,37,2009/2010,2010-05-01 00:00:00,Tottenham Hotspur,Bolton Wanderers,1,0,1.29,5.5,10.0,8,5,11,5,13,12,0,3,0,0,43,18,11,7,58.0,42.0,1,13,16,25,3,0,61,18
739,2412,37,2009/2010,2010-05-01 00:00:00,Stoke City,Everton,0,0,3.6,3.3,2.1,4,8,6,2,10,9,0,0,0,0,14,7,6,5,48.0,52.0,0,12,8,19,0,0,21,11
740,2413,37,2009/2010,2010-05-01 00:00:00,Portsmouth,Wolverhampton Wanderers,3,1,2.38,3.25,3.1,4,11,3,5,8,6,0,1,0,0,18,24,7,8,55.0,45.0,4,15,8,14,1,0,42,15
741,2414,37,2009/2010,2010-05-01 00:00:00,Manchester City,Aston Villa,3,1,1.83,3.6,4.33,11,5,7,4,7,10,1,2,0,0,33,29,13,5,50.0,50.0,4,16,11,17,3,0,62,18
742,2415,37,2009/2010,2010-05-01 00:00:00,Birmingham City,Burnley,2,1,1.5,4.2,7.0,4,5,8,4,9,8,2,1,0,0,13,19,6,8,54.0,46.0,3,9,12,17,3,0,32,14
743,2411,37,2009/2010,2010-05-02 00:00:00,Sunderland,Manchester United,0,1,9.5,4.75,1.36,5,8,6,7,10,10,3,2,0,0,23,21,9,4,42.0,58.0,1,13,13,20,5,0,44,13
744,2417,37,2009/2010,2010-05-02 00:00:00,Fulham,West Ham United,3,2,2.38,3.25,3.1,3,3,1,2,13,15,0,0,0,0,32,24,9,3,57.0,43.0,5,6,3,28,0,0,56,12
745,2418,37,2009/2010,2010-05-02 00:00:00,Liverpool,Chelsea,0,2,4.0,3.8,1.83,2,8,6,5,8,9,1,2,0,0,19,9,9,5,49.0,51.0,2,10,11,17,3,0,28,14
746,2409,37,2009/2010,2010-05-03 00:00:00,Wigan Athletic,Hull City,2,2,1.8,3.6,4.5,3,1,8,3,10,14,2,0,0,0,13,12,8,1,50.0,50.0,4,4,11,24,2,0,25,9
747,2416,37,2009/2010,2010-05-03 00:00:00,Blackburn Rovers,Arsenal,2,1,3.5,3.4,2.1,5,4,2,2,21,16,2,2,0,0,23,28,5,8,46.0,54.0,3,9,4,37,4,0,51,13
748,2321,29,2009/2010,2010-05-05 00:00:00,Manchester City,Tottenham Hotspur,0,1,2.0,3.4,3.8,9,7,6,6,12,19,0,3,0,0,19,15,9,8,52.0,48.0,1,16,12,31,3,0,34,17
749,2328,29,2009/2010,2010-05-05 00:00:00,Fulham,Stoke City,0,1,2.1,3.3,3.6,4,2,8,3,5,9,1,3,0,0,28,17,7,3,53.0,47.0,1,6,11,14,4,0,45,10
750,2419,38,2009/2010,2010-05-09 00:00:00,Wolverhampton Wanderers,Sunderland,2,1,2.25,3.4,3.25,4,4,6,6,11,20,1,2,0,0,8,4,4,1,50.0,50.0,3,8,12,31,3,0,12,5
751,2420,38,2009/2010,2010-05-09 00:00:00,Everton,Portsmouth,1,0,1.29,5.5,11.0,11,4,9,3,8,8,0,0,0,0,10,0,12,1,65.0,35.0,1,15,12,16,0,0,10,13
752,2421,38,2009/2010,2010-05-09 00:00:00,Chelsea,Wigan Athletic,8,0,1.1,10.0,23.0,3,3,7,1,12,10,2,2,0,1,17,7,2,3,58.0,42.0,8,6,8,22,4,1,24,5
753,2422,38,2009/2010,2010-05-09 00:00:00,Burnley,Tottenham Hotspur,4,2,7.0,4.2,1.5,5,5,4,5,6,3,0,0,0,0,11,18,5,6,52.0,48.0,6,10,9,9,0,0,29,11
754,2423,38,2009/2010,2010-05-09 00:00:00,Bolton Wanderers,Birmingham City,2,1,2.25,3.3,3.3,4,5,2,3,16,16,2,5,0,0,11,13,3,6,41.0,59.0,3,9,5,32,7,0,24,9
755,2424,38,2009/2010,2010-05-09 00:00:00,Aston Villa,Blackburn Rovers,0,1,1.57,4.0,6.0,10,2,6,5,7,7,2,1,0,0,34,12,9,6,52.0,48.0,1,12,11,14,3,0,46,15
756,2425,38,2009/2010,2010-05-09 00:00:00,Arsenal,Fulham,4,0,1.2,7.0,13.0,6,1,8,2,11,9,2,2,0,0,7,4,4,2,52.0,48.0,4,7,10,20,4,0,11,6
757,2426,38,2009/2010,2010-05-09 00:00:00,Manchester United,Stoke City,4,0,1.13,8.0,23.0,11,7,8,0,10,6,2,0,0,0,22,11,10,2,55.0,45.0,4,18,8,16,2,0,33,12
758,2427,38,2009/2010,2010-05-09 00:00:00,West Ham United,Manchester City,1,1,4.0,3.6,1.91,6,7,4,6,5,3,2,0,0,0,6,16,4,3,45.0,55.0,2,13,10,8,2,0,22,7
759,2428,38,2009/2010,2010-05-09 00:00:00,Hull City,Liverpool,0,0,6.5,3.8,1.57,8,5,4,11,11,8,1,0,0,0,19,20,2,6,47.0,53.0,0,13,15,19,1,0,39,8
760,2489,1,2010/2011,2010-08-14 00:00:00,Aston Villa,West Ham United,3,0,2.0,3.3,4.0,8,3,11,8,12,14,1,2,0,0,35,14,16,7,60.0,40.0,3,11,19,26,3,0,49,23
761,2490,1,2010/2011,2010-08-14 00:00:00,Blackburn Rovers,Everton,1,0,2.88,3.25,2.5,3,8,6,8,17,14,2,1,0,0,16,27,1,3,42.0,58.0,1,11,14,31,3,0,43,4
762,2491,1,2010/2011,2010-08-14 00:00:00,Bolton Wanderers,Fulham,0,0,2.2,3.3,3.4,9,6,4,8,12,12,1,3,0,0,28,26,4,8,50.0,50.0,0,15,12,24,4,0,54,12
763,2492,1,2010/2011,2010-08-14 00:00:00,Chelsea,West Bromwich Albion,6,0,1.17,7.0,17.0,7,3,5,6,9,9,1,0,0,0,8,7,3,2,58.0,42.0,6,10,11,18,1,0,15,5
764,2495,1,2010/2011,2010-08-14 00:00:00,Sunderland,Birmingham City,2,2,2.1,3.3,3.6,2,3,5,4,8,8,3,3,0,0,14,15,3,6,50.0,50.0,4,5,9,16,6,0,29,9
765,2496,1,2010/2011,2010-08-14 00:00:00,Tottenham Hotspur,Manchester City,0,0,2.4,3.3,3.0,5,6,6,6,13,15,0,2,0,0,26,12,10,3,56.0,44.0,0,11,12,28,2,0,38,13
766,2497,1,2010/2011,2010-08-14 00:00:00,Wolverhampton Wanderers,Stoke City,2,1,2.3,3.25,3.2,8,3,7,3,15,12,0,2,0,0,35,23,5,5,53.0,47.0,3,11,10,27,2,0,58,10
767,2498,1,2010/2011,2010-08-14 00:00:00,Wigan Athletic,Blackpool,0,4,1.83,3.5,4.5,7,4,4,5,6,11,1,1,0,0,13,15,6,4,56.0,44.0,4,11,9,17,2,0,28,10
768,2493,1,2010/2011,2010-08-15 00:00:00,Liverpool,Arsenal,1,1,2.5,3.25,2.88,3,8,3,8,14,17,1,3,1,0,13,26,8,11,48.0,52.0,2,11,11,31,4,1,39,19
769,2494,1,2010/2011,2010-08-16 00:00:00,Manchester United,Newcastle United,3,0,1.25,5.5,15.0,7,4,9,3,9,7,2,2,0,0,34,11,5,3,62.0,38.0,3,11,12,16,4,0,45,8
770,2599,2,2010/2011,2010-08-21 00:00:00,Arsenal,Blackpool,6,0,1.17,7.0,19.0,21,2,8,2,9,4,0,0,0,1,37,23,8,2,57.0,43.0,6,23,10,13,0,1,60,10
771,2600,2,2010/2011,2010-08-21 00:00:00,West Ham United,Bolton Wanderers,1,3,2.25,3.3,3.25,6,5,8,4,7,12,2,4,0,0,16,12,7,5,52.0,48.0,4,11,12,19,6,0,28,12
772,2601,2,2010/2011,2010-08-21 00:00:00,Everton,Wolverhampton Wanderers,1,1,1.5,4.0,7.0,5,3,8,5,12,14,1,2,0,0,21,11,3,3,61.0,39.0,2,8,13,26,3,0,32,6
773,2605,2,2010/2011,2010-08-21 00:00:00,Birmingham City,Blackburn Rovers,2,1,2.2,3.25,3.4,6,5,4,5,13,12,2,3,0,0,12,22,4,11,58.0,42.0,3,11,9,25,5,0,34,15
774,2606,2,2010/2011,2010-08-21 00:00:00,West Bromwich Albion,Sunderland,1,0,2.5,3.25,2.88,3,4,7,4,14,13,3,2,0,0,19,19,4,6,49.0,51.0,1,7,11,27,5,0,38,10
775,2607,2,2010/2011,2010-08-21 00:00:00,Stoke City,Tottenham Hotspur,1,2,3.4,3.3,2.2,12,6,7,1,15,5,3,1,0,0,33,15,6,2,45.0,55.0,3,18,8,20,4,0,48,8
776,2608,2,2010/2011,2010-08-21 00:00:00,Wigan Athletic,Chelsea,0,6,15.0,6.0,1.22,10,3,4,2,12,9,1,2,0,0,14,11,0,0,43.0,57.0,6,13,6,21,3,0,25,0
777,2602,2,2010/2011,2010-08-22 00:00:00,Newcastle United,Aston Villa,6,0,3.2,3.25,2.3,8,2,3,2,16,11,3,1,0,0,24,9,10,2,59.0,41.0,6,10,5,27,4,0,33,12
778,2604,2,2010/2011,2010-08-22 00:00:00,Fulham,Manchester United,2,2,6.0,4.0,1.57,10,10,10,10,11,7,2,2,0,0,29,44,5,11,44.0,56.0,4,20,20,18,4,0,73,16
779,2603,2,2010/2011,2010-08-23 00:00:00,Manchester City,Liverpool,3,0,2.38,3.25,3.1,3,7,6,8,11,13,1,1,0,0,14,17,5,4,62.0,38.0,3,10,14,24,2,0,31,9
780,2709,3,2010/2011,2010-08-28 00:00:00,Manchester United,West Ham United,3,0,1.14,8.0,19.0,7,3,10,5,5,10,1,2,0,0,34,16,9,3,63.0,37.0,3,10,15,15,3,0,50,12
781,2712,3,2010/2011,2010-08-28 00:00:00,Tottenham Hotspur,Wigan Athletic,0,1,1.25,5.75,13.0,10,7,6,7,12,11,3,2,0,0,34,7,16,7,51.0,49.0,1,17,13,23,5,0,41,23
782,2714,3,2010/2011,2010-08-28 00:00:00,Wolverhampton Wanderers,Newcastle United,1,1,2.4,3.2,3.1,2,10,3,4,20,19,7,5,0,0,21,40,5,3,42.0,58.0,2,12,7,39,12,0,61,8
783,2715,3,2010/2011,2010-08-28 00:00:00,Blackburn Rovers,Arsenal,1,2,6.0,4.0,1.57,12,9,6,6,9,6,1,0,0,0,45,26,4,8,41.0,59.0,3,21,12,15,1,0,71,12
784,2717,3,2010/2011,2010-08-28 00:00:00,Blackpool,Fulham,2,2,3.2,3.25,2.3,9,6,10,5,14,16,1,0,0,0,19,15,4,5,51.0,49.0,4,15,15,30,1,0,34,9
785,2718,3,2010/2011,2010-08-28 00:00:00,Chelsea,Stoke City,2,0,1.11,9.0,23.0,8,4,11,7,5,8,0,2,0,0,16,15,6,1,64.0,36.0,2,12,18,13,2,0,31,7
786,2710,3,2010/2011,2010-08-29 00:00:00,Liverpool,West Bromwich Albion,1,0,1.22,6.0,15.0,9,6,2,9,8,10,0,0,0,1,21,22,7,8,56.0,44.0,1,15,11,18,0,1,43,15
787,2711,3,2010/2011,2010-08-29 00:00:00,Sunderland,Manchester City,1,0,4.5,3.5,1.83,6,7,8,1,4,11,0,3,0,0,11,8,3,7,43.0,57.0,1,13,9,15,3,0,19,10
788,2713,3,2010/2011,2010-08-29 00:00:00,Aston Villa,Everton,1,0,2.5,3.25,2.88,7,15,6,5,20,11,4,0,0,0,16,40,4,19,43.0,57.0,1,22,11,31,4,0,56,23
789,2716,3,2010/2011,2010-08-29 00:00:00,Bolton Wanderers,Birmingham City,2,2,2.1,3.3,3.6,9,3,3,5,15,15,2,3,1,0,12,7,6,1,54.0,46.0,4,12,8,30,5,1,19,7
790,2809,4,2010/2011,2010-09-11 00:00:00,Arsenal,Bolton Wanderers,4,1,1.25,5.5,13.0,13,8,9,1,12,11,2,2,0,1,23,25,8,6,58.0,42.0,5,21,10,23,4,1,48,14
791,2810,4,2010/2011,2010-09-11 00:00:00,West Ham United,Chelsea,1,3,10.0,5.0,1.33,4,9,6,7,9,7,2,2,0,0,14,9,1,3,50.0,50.0,4,13,13,16,4,0,23,4
792,2811,4,2010/2011,2010-09-11 00:00:00,Everton,Manchester United,3,3,4.2,3.4,1.91,12,3,12,7,12,19,1,1,0,0,31,19,7,5,48.0,52.0,6,15,19,31,2,0,50,12
793,2812,4,2010/2011,2010-09-11 00:00:00,Newcastle United,Blackpool,0,2,1.57,4.0,6.0,8,3,5,1,14,18,2,3,0,0,27,11,3,2,61.0,39.0,2,11,6,32,5,0,38,5
794,2813,4,2010/2011,2010-09-11 00:00:00,Manchester City,Blackburn Rovers,1,1,1.33,5.0,10.0,11,2,10,3,12,11,2,1,0,0,29,16,14,1,58.0,42.0,2,13,13,23,3,0,45,15
795,2814,4,2010/2011,2010-09-11 00:00:00,Fulham,Wolverhampton Wanderers,2,1,1.83,3.5,4.5,11,4,8,2,8,17,3,6,0,0,24,21,6,6,52.0,48.0,3,15,10,25,9,0,45,12
796,2816,4,2010/2011,2010-09-11 00:00:00,West Bromwich Albion,Tottenham Hotspur,1,1,3.75,3.25,2.1,8,8,7,7,13,10,2,1,0,0,23,12,9,4,44.0,56.0,2,16,14,23,3,0,35,13
797,2818,4,2010/2011,2010-09-11 00:00:00,Wigan Athletic,Sunderland,1,1,2.5,3.25,2.88,3,0,9,2,17,10,4,2,0,0,11,3,5,1,56.0,44.0,2,3,11,27,6,0,14,6
798,2815,4,2010/2011,2010-09-12 00:00:00,Birmingham City,Liverpool,0,0,3.1,3.2,2.4,4,10,12,5,9,9,1,0,0,0,22,23,4,3,52.0,48.0,0,14,17,18,1,0,45,7
799,2817,4,2010/2011,2010-09-13 00:00:00,Stoke City,Aston Villa,2,1,2.5,3.25,2.88,10,5,8,5,12,15,1,2,0,0,28,19,7,8,47.0,53.0,3,15,13,27,3,0,47,15
800,2820,5,2010/2011,2010-09-18 00:00:00,Sunderland,Arsenal,1,1,5.5,3.7,1.67,8,5,10,9,12,12,3,2,0,0,40,19,11,3,48.0,52.0,2,13,19,24,5,0,59,14
801,2821,5,2010/2011,2010-09-18 00:00:00,Tottenham Hotspur,Wolverhampton Wanderers,3,1,1.4,4.5,8.5,14,3,10,3,8,13,2,2,0,0,24,10,5,4,56.0,44.0,4,17,13,21,4,0,34,9
802,2822,5,2010/2011,2010-09-18 00:00:00,Aston Villa,Bolton Wanderers,1,1,1.8,3.6,4.5,8,7,7,7,14,6,1,2,0,0,23,11,8,4,57.0,43.0,2,15,14,20,3,0,34,12
803,2823,5,2010/2011,2010-09-18 00:00:00,Everton,Newcastle United,0,1,1.62,3.75,6.0,6,3,6,6,14,19,2,3,0,0,22,21,3,6,46.0,54.0,1,9,12,33,5,0,43,9
804,2824,5,2010/2011,2010-09-18 00:00:00,Blackburn Rovers,Fulham,1,1,2.0,3.3,4.0,3,3,2,4,18,10,0,1,0,0,12,3,3,2,42.0,58.0,2,6,6,28,1,0,15,5
805,2825,5,2010/2011,2010-09-18 00:00:00,West Bromwich Albion,Birmingham City,3,1,2.25,3.3,3.25,5,2,7,3,12,8,1,1,0,0,17,4,5,0,51.0,49.0,4,7,10,20,2,0,21,5
806,2826,5,2010/2011,2010-09-18 00:00:00,Stoke City,West Ham United,1,1,1.91,3.4,4.2,2,6,7,7,13,10,3,2,0,0,33,9,6,3,62.0,38.0,2,8,14,23,5,0,42,9
807,2819,5,2010/2011,2010-09-19 00:00:00,Manchester United,Liverpool,3,2,1.7,3.5,5.5,5,0,8,5,15,11,4,1,0,0,37,11,6,1,55.0,45.0,5,5,13,26,5,0,48,7
808,2827,5,2010/2011,2010-09-19 00:00:00,Wigan Athletic,Manchester City,0,2,5.0,3.6,1.73,2,4,6,6,11,16,1,2,0,0,15,23,2,0,48.0,52.0,2,6,12,27,3,0,38,2
809,2828,5,2010/2011,2010-09-19 00:00:00,Chelsea,Blackpool,4,0,1.1,9.0,26.0,10,4,13,7,8,6,1,2,0,0,34,19,9,5,58.0,42.0,4,14,20,14,3,0,53,14
810,2829,6,2010/2011,2010-09-25 00:00:00,Arsenal,West Bromwich Albion,2,3,1.22,6.0,15.0,16,5,13,2,15,13,4,3,0,0,54,23,16,5,48.0,52.0,5,21,15,28,7,0,77,21
811,2830,6,2010/2011,2010-09-25 00:00:00,Liverpool,Sunderland,2,2,1.44,4.33,7.5,4,1,9,7,15,7,3,1,0,0,10,12,3,3,54.0,46.0,4,5,16,22,4,0,22,6
812,2831,6,2010/2011,2010-09-25 00:00:00,West Ham United,Tottenham Hotspur,1,0,3.5,3.4,2.1,9,10,12,10,10,12,2,0,0,0,29,20,14,7,55.0,45.0,1,19,22,22,2,0,49,21
813,2833,6,2010/2011,2010-09-25 00:00:00,Manchester City,Chelsea,1,0,3.6,3.3,2.1,8,6,2,13,13,13,2,3,0,0,17,18,3,4,50.0,50.0,1,14,15,26,5,0,35,7
814,2835,6,2010/2011,2010-09-25 00:00:00,Fulham,Everton,0,0,2.75,3.2,2.63,5,10,8,7,14,15,2,1,0,0,15,18,4,5,46.0,54.0,0,15,15,29,3,0,33,9
815,2836,6,2010/2011,2010-09-25 00:00:00,Birmingham City,Wigan Athletic,0,0,1.83,3.5,4.5,3,9,6,4,13,16,2,3,1,0,9,7,3,7,54.0,46.0,0,12,10,29,5,1,16,10
816,2838,6,2010/2011,2010-09-25 00:00:00,Blackpool,Blackburn Rovers,1,2,3.2,3.25,2.3,6,6,7,6,12,13,2,1,0,0,34,30,6,8,53.0,47.0,3,12,13,25,3,0,64,14
817,2832,6,2010/2011,2010-09-26 00:00:00,Newcastle United,Stoke City,1,2,1.91,3.4,4.2,9,3,4,6,7,11,0,1,0,0,38,24,3,5,57.0,43.0,3,12,10,18,1,0,62,8
818,2834,6,2010/2011,2010-09-26 00:00:00,Wolverhampton Wanderers,Aston Villa,1,2,2.88,3.25,2.5,10,6,3,2,14,18,1,2,0,0,23,13,5,4,50.0,50.0,3,16,5,32,3,0,36,9
819,2837,6,2010/2011,2010-09-26 00:00:00,Bolton Wanderers,Manchester United,2,2,7.5,4.0,1.5,4,6,10,6,16,15,1,2,0,0,14,35,7,12,40.0,60.0,4,10,16,31,3,0,49,19
820,2840,7,2010/2011,2010-10-02 00:00:00,Sunderland,Manchester United,0,0,5.0,3.5,1.75,13,6,8,6,11,6,1,2,0,0,31,19,10,4,49.0,51.0,0,19,14,17,3,0,50,14
821,2841,7,2010/2011,2010-10-02 00:00:00,Tottenham Hotspur,Aston Villa,2,1,1.91,3.5,4.0,12,4,11,7,13,18,1,3,0,0,21,17,11,4,61.0,39.0,3,16,18,31,4,0,38,15
822,2842,7,2010/2011,2010-10-02 00:00:00,West Ham United,Fulham,1,1,2.25,3.25,3.3,6,5,7,10,19,9,3,1,0,0,12,11,2,3,46.0,54.0,2,11,17,28,4,0,23,5
823,2844,7,2010/2011,2010-10-02 00:00:00,Birmingham City,Everton,0,2,2.88,3.1,2.63,3,6,3,4,5,10,0,0,0,0,27,27,6,5,49.0,51.0,2,9,7,15,0,0,54,11
824,2845,7,2010/2011,2010-10-02 00:00:00,West Bromwich Albion,Bolton Wanderers,1,1,2.1,3.25,3.75,4,4,9,3,8,11,3,2,0,0,10,12,5,5,54.0,46.0,2,8,12,19,5,0,22,10
825,2846,7,2010/2011,2010-10-02 00:00:00,Stoke City,Blackburn Rovers,1,0,2.25,3.2,3.4,11,4,10,3,8,13,2,3,0,0,43,41,8,6,44.0,56.0,1,15,13,21,5,0,84,14
826,2847,7,2010/2011,2010-10-02 00:00:00,Wigan Athletic,Wolverhampton Wanderers,2,0,2.25,3.25,3.3,12,1,9,1,9,15,1,2,0,1,15,8,3,3,56.0,44.0,2,13,10,24,3,1,23,6
827,2839,7,2010/2011,2010-10-03 00:00:00,Liverpool,Blackpool,1,2,1.33,5.0,10.0,8,4,14,9,11,8,2,1,0,0,31,5,5,2,58.0,42.0,3,12,23,19,3,0,36,7
828,2843,7,2010/2011,2010-10-03 00:00:00,Manchester City,Newcastle United,2,1,1.44,4.0,8.5,8,4,6,4,12,13,3,2,0,0,22,22,4,4,57.0,43.0,3,12,10,25,5,0,44,8
829,2848,7,2010/2011,2010-10-03 00:00:00,Chelsea,Arsenal,2,0,1.73,3.6,5.0,9,5,7,9,7,12,1,1,0,0,21,31,10,10,50.0,50.0,2,14,16,19,2,0,52,20
830,2849,8,2010/2011,2010-10-16 00:00:00,Manchester United,West Bromwich Albion,2,2,1.25,5.75,12.0,10,2,9,9,10,10,1,2,0,0,22,15,3,2,57.0,43.0,4,12,18,20,3,0,37,5
831,2850,8,2010/2011,2010-10-16 00:00:00,Arsenal,Birmingham City,2,1,1.29,5.5,11.0,15,4,4,1,15,9,2,2,1,0,16,7,7,3,59.0,41.0,3,19,5,24,4,1,23,10
832,2851,8,2010/2011,2010-10-16 00:00:00,Aston Villa,Chelsea,0,0,5.0,3.6,1.73,3,7,8,8,11,12,4,3,0,0,18,21,9,5,50.0,50.0,0,10,16,23,7,0,39,14
833,2853,8,2010/2011,2010-10-16 00:00:00,Newcastle United,Wigan Athletic,2,2,1.83,3.5,4.5,1,1,8,4,15,17,2,1,0,0,29,9,6,3,57.0,43.0,4,2,12,32,3,0,38,9
834,2854,8,2010/2011,2010-10-16 00:00:00,Wolverhampton Wanderers,West Ham United,1,1,2.25,3.2,3.4,6,7,7,4,12,9,0,0,0,0,14,9,8,3,52.0,48.0,2,13,11,21,0,0,23,11
835,2856,8,2010/2011,2010-10-16 00:00:00,Fulham,Tottenham Hotspur,1,2,2.88,3.25,2.5,7,7,7,8,9,14,1,1,0,0,10,15,4,11,52.0,48.0,3,14,15,23,2,0,25,15
836,2857,8,2010/2011,2010-10-16 00:00:00,Bolton Wanderers,Stoke City,2,1,2.2,3.2,3.5,3,3,5,4,12,8,2,2,0,0,31,27,5,6,50.0,50.0,3,6,9,20,4,0,58,11
837,2852,8,2010/2011,2010-10-17 00:00:00,Everton,Liverpool,2,0,2.4,3.25,3.0,5,12,5,7,10,13,2,3,0,0,22,31,8,8,46.0,54.0,2,17,12,23,5,0,53,16
838,2858,8,2010/2011,2010-10-17 00:00:00,Blackpool,Manchester City,2,3,5.5,4.0,1.62,5,4,10,6,8,14,0,2,0,0,19,24,3,8,58.0,42.0,5,9,16,22,2,0,43,11
839,2855,8,2010/2011,2010-10-18 00:00:00,Blackburn Rovers,Sunderland,0,0,2.1,3.3,3.6,3,7,6,9,14,15,2,1,1,0,22,22,5,3,51.0,49.0,0,10,15,29,3,1,44,8
840,2860,9,2010/2011,2010-10-23 00:00:00,Sunderland,Aston Villa,1,0,2.4,3.25,3.0,4,5,10,8,13,12,1,2,0,0,19,31,4,11,49.0,51.0,1,9,18,25,3,0,50,15
841,2861,9,2010/2011,2010-10-23 00:00:00,Tottenham Hotspur,Everton,1,1,2.1,3.25,3.75,6,3,7,5,16,14,3,1,0,0,32,16,3,4,50.0,50.0,2,9,12,30,4,0,48,7
842,2862,9,2010/2011,2010-10-23 00:00:00,West Ham United,Newcastle United,1,2,2.38,3.25,3.1,1,7,5,1,7,6,0,0,0,0,16,22,2,6,48.0,52.0,3,8,6,13,0,0,38,8
843,2864,9,2010/2011,2010-10-23 00:00:00,Birmingham City,Blackpool,2,0,1.83,3.6,4.33,6,10,8,5,5,9,1,1,0,0,19,24,8,8,57.0,43.0,2,16,13,14,2,0,43,16
844,2865,9,2010/2011,2010-10-23 00:00:00,West Bromwich Albion,Fulham,2,1,2.2,3.25,3.4,6,2,9,7,4,9,0,0,0,0,19,17,7,5,51.0,49.0,3,8,16,13,0,0,36,12
845,2867,9,2010/2011,2010-10-23 00:00:00,Wigan Athletic,Bolton Wanderers,1,1,2.38,3.25,3.1,3,2,10,4,4,14,0,2,0,0,5,5,4,0,48.0,52.0,2,5,14,18,2,0,10,4
846,2868,9,2010/2011,2010-10-23 00:00:00,Chelsea,Wolverhampton Wanderers,2,0,1.13,8.5,19.0,8,10,9,3,9,9,1,2,0,0,19,18,8,8,55.0,45.0,2,18,12,18,3,0,37,16
847,2859,9,2010/2011,2010-10-24 00:00:00,Liverpool,Blackburn Rovers,2,1,1.67,3.6,5.5,4,0,10,4,16,9,2,3,0,0,21,13,13,4,68.0,32.0,3,4,14,25,5,0,34,17
848,2863,9,2010/2011,2010-10-24 00:00:00,Manchester City,Arsenal,0,3,2.5,3.2,2.9,6,8,3,4,8,12,2,4,1,0,25,35,6,7,40.0,60.0,3,14,7,20,6,1,60,13
849,2866,9,2010/2011,2010-10-24 00:00:00,Stoke City,Manchester United,1,2,5.5,3.75,1.67,2,5,6,8,7,14,2,2,0,0,32,22,5,6,47.0,53.0,3,7,14,21,4,0,54,11
850,2499,10,2010/2011,2010-10-30 00:00:00,Manchester United,Tottenham Hotspur,2,0,1.57,4.0,6.0,8,6,9,7,11,11,0,3,0,0,5,19,1,4,48.0,52.0,2,14,16,22,3,0,24,5
851,2500,10,2010/2011,2010-10-30 00:00:00,Arsenal,West Ham United,1,0,1.17,7.0,17.0,18,5,7,2,15,19,2,2,0,0,43,18,8,4,54.0,46.0,1,23,9,34,4,0,61,12
852,2502,10,2010/2011,2010-10-30 00:00:00,Everton,Stoke City,1,0,1.57,3.75,6.5,6,0,8,5,14,10,1,1,0,0,6,3,5,2,67.0,33.0,1,6,13,24,2,0,9,7
853,2504,10,2010/2011,2010-10-30 00:00:00,Wolverhampton Wanderers,Manchester City,2,1,5.5,3.4,1.73,2,4,5,15,5,14,1,2,0,0,14,13,5,7,57.0,43.0,3,6,20,19,3,0,27,12
854,2505,10,2010/2011,2010-10-30 00:00:00,Blackburn Rovers,Chelsea,1,2,7.5,4.33,1.44,6,5,6,6,12,11,2,2,0,0,18,20,3,5,41.0,59.0,3,11,12,23,4,0,38,8
855,2506,10,2010/2011,2010-10-30 00:00:00,Fulham,Wigan Athletic,2,0,1.91,3.4,4.2,6,3,5,5,8,12,0,0,0,0,20,5,7,1,58.0,42.0,2,9,10,20,0,0,25,8
856,2501,10,2010/2011,2010-10-31 00:00:00,Aston Villa,Birmingham City,0,0,1.8,3.6,4.5,3,7,4,4,16,10,2,3,0,0,13,18,2,3,56.0,44.0,0,10,8,26,5,0,31,5
857,2503,10,2010/2011,2010-10-31 00:00:00,Newcastle United,Sunderland,5,1,2.2,3.2,3.5,11,6,7,7,10,19,3,6,0,1,26,18,8,6,60.0,40.0,6,17,14,29,9,1,44,14
858,2507,10,2010/2011,2010-10-31 00:00:00,Bolton Wanderers,Liverpool,0,1,3.4,3.25,2.2,9,4,6,7,14,12,2,2,0,0,21,16,1,4,50.0,50.0,1,13,13,26,4,0,37,5
859,2508,10,2010/2011,2010-11-01 00:00:00,Blackpool,West Bromwich Albion,2,1,2.9,3.25,2.5,7,5,11,7,10,10,2,3,0,2,19,8,7,3,57.0,43.0,3,12,18,20,5,2,27,10
860,2509,11,2010/2011,2010-11-06 00:00:00,Manchester United,Wolverhampton Wanderers,2,1,1.22,6.0,15.0,8,3,7,3,7,10,1,0,0,0,28,13,3,2,57.0,43.0,3,11,10,17,1,0,41,5
861,2512,11,2010/2011,2010-11-06 00:00:00,Sunderland,Stoke City,2,0,2.1,3.2,3.75,2,3,9,11,6,14,0,5,0,0,9,16,6,8,53.0,47.0,2,5,20,20,5,0,25,14
862,2513,11,2010/2011,2010-11-06 00:00:00,Blackburn Rovers,Wigan Athletic,2,1,1.8,3.6,4.5,2,8,5,3,13,15,0,2,0,0,12,8,3,6,37.0,63.0,3,10,8,28,2,0,20,9
863,2514,11,2010/2011,2010-11-06 00:00:00,Fulham,Aston Villa,1,1,2.2,3.25,3.4,9,8,5,7,14,6,1,0,0,0,29,27,3,3,52.0,48.0,2,17,12,20,1,0,56,6
864,2515,11,2010/2011,2010-11-06 00:00:00,Birmingham City,West Ham United,2,2,1.91,3.4,4.2,5,9,5,10,14,16,0,1,0,0,21,23,3,4,54.0,46.0,4,14,15,30,1,0,44,7
865,2516,11,2010/2011,2010-11-06 00:00:00,Bolton Wanderers,Tottenham Hotspur,4,2,3.0,3.3,2.4,3,1,10,7,13,10,1,0,0,0,20,23,7,5,56.0,44.0,6,4,17,23,1,0,43,12
866,2518,11,2010/2011,2010-11-06 00:00:00,Blackpool,Everton,2,2,4.5,3.6,1.8,3,6,5,6,13,14,2,1,0,0,8,27,3,7,38.0,62.0,4,9,11,27,3,0,35,10
867,2510,11,2010/2011,2010-11-07 00:00:00,Arsenal,Newcastle United,0,1,1.29,5.5,11.0,6,2,4,4,16,10,3,1,1,0,52,26,12,2,49.0,51.0,1,8,8,26,4,1,78,14
868,2511,11,2010/2011,2010-11-07 00:00:00,Liverpool,Chelsea,2,0,3.8,3.4,2.0,4,6,3,5,15,15,0,2,0,0,6,24,2,5,34.0,66.0,2,10,8,30,2,0,30,7
869,2517,11,2010/2011,2010-11-07 00:00:00,West Bromwich Albion,Manchester City,0,2,3.6,3.3,2.1,4,5,4,3,11,16,3,4,0,1,11,5,6,1,45.0,55.0,2,9,7,27,7,1,16,7
870,2519,12,2010/2011,2010-11-09 00:00:00,Tottenham Hotspur,Sunderland,1,1,1.53,4.0,6.5,14,4,13,4,7,14,2,1,0,0,50,7,17,3,60.0,40.0,2,18,17,21,3,0,57,20
871,2522,12,2010/2011,2010-11-09 00:00:00,Stoke City,Birmingham City,3,2,2.1,3.2,3.75,6,8,8,4,8,10,0,0,0,0,45,20,10,4,45.0,55.0,5,14,12,18,0,0,65,14
872,2520,12,2010/2011,2010-11-10 00:00:00,West Ham United,West Bromwich Albion,2,2,2.3,3.25,3.2,3,8,4,8,14,6,3,0,0,0,15,17,6,7,52.0,48.0,4,11,12,20,3,0,32,13
873,2521,12,2010/2011,2010-11-10 00:00:00,Wolverhampton Wanderers,Arsenal,0,2,5.5,3.6,1.67,9,5,8,6,7,13,1,2,0,0,41,30,5,1,50.0,50.0,2,14,14,20,3,0,71,6
874,2523,12,2010/2011,2010-11-10 00:00:00,Wigan Athletic,Liverpool,1,1,4.75,3.6,1.75,10,1,2,5,9,11,0,2,0,0,21,10,5,4,55.0,45.0,2,11,7,20,2,0,31,9
875,2524,12,2010/2011,2010-11-10 00:00:00,Aston Villa,Blackpool,3,2,1.62,3.75,6.0,6,3,7,9,8,9,2,3,0,0,21,17,10,8,41.0,59.0,5,9,16,17,5,0,38,18
876,2525,12,2010/2011,2010-11-10 00:00:00,Everton,Bolton Wanderers,1,1,1.62,3.75,6.0,9,3,15,7,10,10,0,3,1,0,36,15,15,10,63.0,37.0,2,12,22,20,3,1,51,25
877,2526,12,2010/2011,2010-11-10 00:00:00,Newcastle United,Blackburn Rovers,1,2,1.91,3.4,4.2,2,1,5,3,15,21,3,4,0,0,21,12,4,1,55.0,45.0,3,3,8,36,7,0,33,5
878,2527,12,2010/2011,2010-11-10 00:00:00,Manchester City,Manchester United,0,0,2.63,3.25,2.75,3,8,6,4,12,11,0,2,0,0,21,17,8,5,48.0,52.0,0,11,10,23,2,0,38,13
879,2528,12,2010/2011,2010-11-10 00:00:00,Chelsea,Fulham,1,0,1.2,6.5,15.0,9,4,10,3,14,14,2,0,1,0,17,9,4,4,63.0,37.0,1,13,13,28,2,1,26,8
880,2529,13,2010/2011,2010-11-13 00:00:00,Tottenham Hotspur,Blackburn Rovers,4,2,1.57,3.8,6.5,10,13,7,2,12,13,2,2,0,0,24,21,12,6,58.0,42.0,6,23,9,25,4,0,45,18
881,2530,13,2010/2011,2010-11-13 00:00:00,West Ham United,Blackpool,0,0,1.91,3.6,4.0,7,4,13,10,7,10,0,1,0,0,14,15,8,7,47.0,53.0,0,11,23,17,1,0,29,15
882,2531,13,2010/2011,2010-11-13 00:00:00,Aston Villa,Manchester United,2,2,4.5,3.6,1.8,5,6,9,8,11,9,3,4,0,0,39,24,9,7,45.0,55.0,4,11,17,20,7,0,63,16
883,2533,13,2010/2011,2010-11-13 00:00:00,Newcastle United,Fulham,0,0,1.91,3.4,4.2,8,8,8,2,12,17,2,2,0,0,22,13,5,5,65.0,35.0,0,16,10,29,4,0,35,10
884,2534,13,2010/2011,2010-11-13 00:00:00,Manchester City,Birmingham City,0,0,1.4,4.5,8.5,15,5,12,2,16,10,2,0,0,0,34,13,6,4,57.0,43.0,0,20,14,26,2,0,47,10
885,2535,13,2010/2011,2010-11-13 00:00:00,Wolverhampton Wanderers,Bolton Wanderers,2,3,2.4,3.1,3.2,7,8,5,8,13,11,1,0,0,0,49,29,12,4,58.0,42.0,5,15,13,24,1,0,78,16
886,2536,13,2010/2011,2010-11-13 00:00:00,Stoke City,Liverpool,2,0,3.75,3.25,2.1,5,6,8,4,14,11,2,3,0,0,28,20,4,3,64.0,36.0,2,11,12,25,5,0,48,7
887,2537,13,2010/2011,2010-11-13 00:00:00,Wigan Athletic,West Bromwich Albion,1,0,2.5,3.25,2.88,3,8,8,4,16,13,1,1,0,0,32,26,5,5,55.0,45.0,1,11,12,29,2,0,58,10
888,2532,13,2010/2011,2010-11-14 00:00:00,Everton,Arsenal,1,2,3.4,3.3,2.2,13,5,7,6,16,14,2,2,0,0,41,19,9,2,47.0,53.0,3,18,13,30,4,0,60,11
889,2538,13,2010/2011,2010-11-14 00:00:00,Chelsea,Sunderland,0,3,1.22,5.75,15.0,5,3,5,10,6,12,1,2,0,0,9,7,6,3,47.0,53.0,3,8,15,18,3,0,16,9
890,2539,14,2010/2011,2010-11-20 00:00:00,Manchester United,Wigan Athletic,2,0,1.22,6.0,15.0,7,4,7,6,11,16,0,2,0,1,48,5,11,1,65.0,35.0,2,11,13,27,2,1,53,12
891,2540,14,2010/2011,2010-11-20 00:00:00,Arsenal,Tottenham Hotspur,2,3,1.62,4.0,5.5,6,5,6,4,19,17,3,1,0,0,48,29,2,6,53.0,47.0,5,11,10,36,4,0,77,8
892,2541,14,2010/2011,2010-11-20 00:00:00,Liverpool,West Ham United,3,0,1.57,3.8,6.5,9,3,12,5,7,10,0,1,0,0,25,16,10,2,62.0,38.0,3,12,17,17,1,0,41,12
893,2545,14,2010/2011,2010-11-20 00:00:00,Birmingham City,Chelsea,1,0,5.0,3.6,1.73,0,10,3,17,10,2,2,0,0,0,4,28,4,16,41.0,59.0,1,10,20,12,2,0,32,20
894,2546,14,2010/2011,2010-11-20 00:00:00,Bolton Wanderers,Newcastle United,5,1,2.1,3.3,3.6,8,1,9,5,14,12,1,2,0,1,23,25,2,3,51.0,49.0,6,9,14,26,3,1,48,5
895,2547,14,2010/2011,2010-11-20 00:00:00,West Bromwich Albion,Stoke City,0,3,2.2,3.2,3.5,10,4,6,2,10,11,0,0,0,0,20,14,8,3,50.0,50.0,3,14,8,21,0,0,34,11
896,2548,14,2010/2011,2010-11-20 00:00:00,Blackpool,Wolverhampton Wanderers,2,1,2.5,3.3,2.88,3,3,4,10,8,10,0,2,0,0,7,21,3,7,44.0,56.0,3,6,14,18,2,0,28,10
897,2543,14,2010/2011,2010-11-21 00:00:00,Blackburn Rovers,Aston Villa,2,0,2.3,3.25,3.25,6,12,7,5,13,11,0,1,0,0,30,47,5,8,49.0,51.0,2,18,12,24,1,0,77,13
898,2544,14,2010/2011,2010-11-21 00:00:00,Fulham,Manchester City,1,4,3.2,3.1,2.4,7,3,7,4,14,15,2,1,0,0,43,32,7,7,41.0,59.0,5,10,11,29,3,0,75,14
899,2542,14,2010/2011,2010-11-22 00:00:00,Sunderland,Everton,2,2,2.6,3.2,2.8,4,7,7,5,6,8,0,2,0,0,16,30,4,4,46.0,54.0,4,11,12,14,2,0,46,8
900,2549,15,2010/2011,2010-11-27 00:00:00,Manchester United,Blackburn Rovers,7,1,1.25,5.5,13.0,5,1,4,2,6,6,0,2,0,0,25,14,5,2,64.0,36.0,8,6,6,12,2,0,39,7
901,2551,15,2010/2011,2010-11-27 00:00:00,West Ham United,Wigan Athletic,3,1,2.0,3.5,3.75,6,6,5,0,6,6,0,0,0,0,15,10,7,3,50.0,50.0,4,12,5,12,0,0,25,10
902,2552,15,2010/2011,2010-11-27 00:00:00,Aston Villa,Arsenal,2,4,3.4,3.3,2.2,3,7,2,7,10,7,1,1,0,0,17,22,3,8,40.0,60.0,6,10,9,17,2,0,39,11
903,2553,15,2010/2011,2010-11-27 00:00:00,Everton,West Bromwich Albion,1,4,1.57,3.8,6.5,2,2,4,1,5,10,1,3,1,0,5,6,2,2,41.0,59.0,5,4,5,15,4,1,11,4
904,2555,15,2010/2011,2010-11-27 00:00:00,Wolverhampton Wanderers,Sunderland,3,2,2.6,3.2,2.8,6,6,7,8,12,12,2,3,0,0,49,19,11,5,56.0,44.0,5,12,15,24,5,0,68,16
905,2556,15,2010/2011,2010-11-27 00:00:00,Fulham,Birmingham City,1,1,2.0,3.3,4.0,5,3,10,4,11,9,1,0,0,0,27,16,8,4,50.0,50.0,2,8,14,20,1,0,43,12
906,2557,15,2010/2011,2010-11-27 00:00:00,Bolton Wanderers,Blackpool,2,2,1.57,4.2,5.5,10,6,11,6,8,12,2,2,0,0,19,19,4,4,43.0,57.0,4,16,17,20,4,0,38,8
907,2558,15,2010/2011,2010-11-27 00:00:00,Stoke City,Manchester City,1,1,3.4,3.25,2.2,9,6,8,5,9,10,2,2,0,0,48,38,6,3,49.0,51.0,2,15,13,19,4,0,86,9
908,2550,15,2010/2011,2010-11-28 00:00:00,Tottenham Hotspur,Liverpool,2,1,2.0,3.4,3.8,8,4,10,13,6,16,0,5,0,0,10,18,5,8,55.0,45.0,3,12,23,22,5,0,28,13
909,2554,15,2010/2011,2010-11-28 00:00:00,Newcastle United,Chelsea,1,1,5.0,3.6,1.73,2,14,2,7,10,12,2,1,0,0,19,23,6,7,43.0,57.0,2,16,9,22,3,0,42,13
910,2559,16,2010/2011,2010-12-04 00:00:00,Arsenal,Fulham,2,1,1.29,5.25,12.0,8,5,6,5,6,8,0,0,0,0,24,18,3,7,51.0,49.0,3,13,11,14,0,0,42,10
911,2562,16,2010/2011,2010-12-04 00:00:00,Manchester City,Bolton Wanderers,1,0,1.53,4.0,6.5,11,7,9,5,12,20,3,2,0,0,20,20,8,8,62.0,38.0,1,18,14,32,5,0,40,16
912,2563,16,2010/2011,2010-12-04 00:00:00,Blackburn Rovers,Wolverhampton Wanderers,3,0,1.73,3.6,5.0,3,5,2,4,10,12,0,2,0,0,15,20,8,10,38.0,62.0,3,8,6,22,2,0,35,18
913,2564,16,2010/2011,2010-12-04 00:00:00,Birmingham City,Tottenham Hotspur,1,1,3.5,3.4,2.1,3,7,9,12,15,9,1,1,0,0,31,31,6,12,45.0,55.0,2,10,21,24,2,0,62,18
914,2567,16,2010/2011,2010-12-04 00:00:00,Wigan Athletic,Stoke City,2,2,2.75,3.2,2.63,6,3,8,2,6,8,1,4,0,0,8,10,5,4,52.0,48.0,4,9,10,14,5,0,18,9
915,2568,16,2010/2011,2010-12-04 00:00:00,Chelsea,Everton,1,1,1.36,4.75,9.0,6,3,9,11,8,11,1,4,0,0,14,8,7,2,55.0,45.0,2,9,20,19,5,0,22,9
916,2561,16,2010/2011,2010-12-05 00:00:00,Sunderland,West Ham United,1,0,1.83,3.5,4.5,8,2,9,6,7,9,1,3,0,0,27,17,9,3,57.0,43.0,1,10,15,16,4,0,44,12
917,2565,16,2010/2011,2010-12-05 00:00:00,West Bromwich Albion,Newcastle United,3,1,2.25,3.3,3.25,7,6,12,6,11,9,0,5,0,0,26,19,7,3,57.0,43.0,4,13,18,20,5,0,45,10
918,2560,16,2010/2011,2010-12-06 00:00:00,Liverpool,Aston Villa,3,0,1.62,3.75,6.0,5,4,6,3,14,13,0,1,0,0,13,17,4,3,50.0,50.0,3,9,9,27,1,0,30,7
919,2571,17,2010/2011,2010-12-11 00:00:00,West Ham United,Manchester City,1,3,4.5,3.6,1.8,4,7,10,3,9,16,1,3,0,0,17,24,2,6,50.0,50.0,4,11,13,25,4,0,41,8
920,2572,17,2010/2011,2010-12-11 00:00:00,Aston Villa,West Bromwich Albion,2,1,2.1,3.3,3.6,4,4,3,7,6,14,0,2,0,0,14,25,6,13,49.0,51.0,3,8,10,20,2,0,39,19
921,2573,17,2010/2011,2010-12-11 00:00:00,Everton,Wigan Athletic,0,0,1.4,4.5,9.0,7,4,9,0,13,17,2,4,0,0,48,24,10,4,53.0,47.0,0,11,9,30,6,0,72,14
922,2574,17,2010/2011,2010-12-11 00:00:00,Newcastle United,Liverpool,3,1,3.8,3.4,2.0,2,8,4,9,21,13,2,1,0,0,12,21,2,5,47.0,53.0,4,10,13,34,3,0,33,7
923,2576,17,2010/2011,2010-12-11 00:00:00,Fulham,Sunderland,0,0,2.2,3.25,3.4,14,4,1,9,14,8,0,1,0,0,19,16,4,3,49.0,51.0,0,18,10,22,1,0,35,7
924,2578,17,2010/2011,2010-12-11 00:00:00,Stoke City,Blackpool,0,1,1.62,4.0,5.5,12,3,14,5,12,11,0,2,0,0,43,22,10,4,46.0,54.0,1,15,19,23,2,0,65,14
925,2570,17,2010/2011,2010-12-12 00:00:00,Tottenham Hotspur,Chelsea,1,1,2.8,3.25,2.6,2,7,9,6,10,15,2,2,0,0,14,27,1,7,41.0,59.0,2,9,15,25,4,0,41,8
926,2575,17,2010/2011,2010-12-12 00:00:00,Wolverhampton Wanderers,Birmingham City,1,0,2.4,3.25,3.0,9,0,5,3,9,10,2,4,0,0,27,18,7,2,52.0,48.0,1,9,8,19,6,0,45,9
927,2577,17,2010/2011,2010-12-12 00:00:00,Bolton Wanderers,Blackburn Rovers,2,1,2.0,3.3,4.0,6,11,3,9,14,16,4,3,0,0,20,43,3,10,49.0,51.0,3,17,12,30,7,0,63,13
928,2569,17,2010/2011,2010-12-13 00:00:00,Manchester United,Arsenal,1,0,2.0,3.4,3.8,8,4,4,6,5,17,0,4,0,0,11,12,5,4,50.0,50.0,1,12,10,22,4,0,23,9
929,2581,18,2010/2011,2010-12-18 00:00:00,Sunderland,Bolton Wanderers,1,0,2.2,3.2,3.5,5,8,7,6,7,13,1,3,0,0,21,32,2,5,51.0,49.0,1,13,13,20,4,0,53,7
930,2583,18,2010/2011,2010-12-18 00:00:00,Blackburn Rovers,West Ham United,1,1,1.8,3.6,4.5,4,1,6,8,10,10,2,3,0,0,12,13,9,4,55.0,45.0,2,5,14,20,5,0,25,13
931,2582,18,2010/2011,2010-12-20 00:00:00,Manchester City,Everton,1,2,1.73,3.6,5.0,24,1,12,0,10,13,3,2,0,0,55,10,11,0,58.0,42.0,3,25,12,23,5,0,65,11
932,2589,19,2010/2011,2010-12-26 00:00:00,Manchester United,Sunderland,2,0,1.29,5.5,11.0,8,1,6,5,12,9,0,2,0,0,19,17,5,3,53.0,47.0,2,9,11,21,2,0,36,8
933,2591,19,2010/2011,2010-12-26 00:00:00,Aston Villa,Tottenham Hotspur,1,2,3.2,3.3,2.3,16,6,11,5,13,10,3,3,0,1,39,4,8,4,63.0,37.0,3,22,16,23,6,1,43,12
934,2593,19,2010/2011,2010-12-26 00:00:00,Newcastle United,Manchester City,1,3,3.25,3.25,2.25,9,3,11,3,6,14,1,5,0,0,38,12,6,3,55.0,45.0,4,12,14,20,6,0,50,9
935,2594,19,2010/2011,2010-12-26 00:00:00,Wolverhampton Wanderers,Wigan Athletic,1,2,2.1,3.3,3.6,4,5,4,6,5,15,1,3,0,0,23,5,7,3,56.0,44.0,3,9,10,20,4,0,28,10
936,2595,19,2010/2011,2010-12-26 00:00:00,Blackburn Rovers,Stoke City,0,2,2.3,3.2,3.2,8,7,5,3,13,20,1,4,0,0,27,34,5,3,48.0,52.0,2,15,8,33,5,0,61,8
937,2596,19,2010/2011,2010-12-26 00:00:00,Fulham,West Ham United,1,3,1.91,3.4,4.2,10,5,9,6,13,10,1,1,0,0,32,16,8,4,50.0,50.0,4,15,15,23,2,0,48,12
938,2597,19,2010/2011,2010-12-26 00:00:00,Bolton Wanderers,West Bromwich Albion,2,0,2.1,3.25,3.75,6,10,5,6,8,9,1,1,0,0,11,19,5,7,45.0,55.0,2,16,11,17,2,0,30,12
939,2590,19,2010/2011,2010-12-27 00:00:00,Arsenal,Chelsea,3,1,2.63,3.2,2.75,6,5,3,7,14,16,2,3,0,0,15,14,4,6,61.0,39.0,4,11,10,30,5,0,29,10
940,2610,20,2010/2011,2010-12-28 00:00:00,Sunderland,Blackpool,0,2,1.62,3.75,6.0,11,2,16,5,9,4,2,0,0,0,33,10,9,2,55.0,45.0,2,13,21,13,2,0,43,11
941,2611,20,2010/2011,2010-12-28 00:00:00,Tottenham Hotspur,Newcastle United,2,0,1.53,4.0,6.5,9,8,6,4,9,16,2,4,1,0,19,22,9,7,55.0,45.0,2,17,10,25,6,1,41,16
942,2612,20,2010/2011,2010-12-28 00:00:00,West Ham United,Everton,1,1,3.4,3.2,2.25,4,4,6,11,12,19,1,0,0,0,13,24,4,7,49.0,51.0,2,8,17,31,1,0,37,11
943,2613,20,2010/2011,2010-12-28 00:00:00,Manchester City,Aston Villa,4,0,1.44,4.2,8.0,5,4,3,6,8,9,1,2,0,0,9,5,8,6,53.0,47.0,4,9,9,17,3,0,14,14
944,2614,20,2010/2011,2010-12-28 00:00:00,Birmingham City,Manchester United,1,1,6.5,4.33,1.5,2,5,9,8,12,9,3,3,0,0,19,18,4,4,51.0,49.0,2,7,17,21,6,0,37,8
945,2615,20,2010/2011,2010-12-28 00:00:00,West Bromwich Albion,Blackburn Rovers,1,3,1.83,3.5,4.5,8,1,11,4,9,11,1,3,1,1,15,14,8,5,61.0,39.0,4,9,15,20,4,2,29,13
946,2616,20,2010/2011,2010-12-28 00:00:00,Stoke City,Fulham,0,2,1.83,3.4,4.75,11,2,7,1,8,15,1,2,0,0,41,9,9,2,52.0,48.0,2,13,8,23,3,0,50,11
947,2609,20,2010/2011,2010-12-29 00:00:00,Liverpool,Wolverhampton Wanderers,0,1,1.33,5.0,10.0,7,2,5,8,8,11,1,1,0,0,22,28,2,8,55.0,45.0,1,9,13,19,2,0,50,10
948,2617,20,2010/2011,2010-12-29 00:00:00,Wigan Athletic,Arsenal,2,2,6.5,4.2,1.5,5,7,2,6,16,10,1,0,1,0,23,27,3,4,47.0,53.0,4,12,8,26,1,1,50,7
949,2618,20,2010/2011,2010-12-29 00:00:00,Chelsea,Bolton Wanderers,1,0,1.29,5.5,11.0,7,5,10,6,13,25,1,1,0,0,18,17,6,3,54.0,46.0,1,12,16,38,2,0,35,9
950,2619,21,2010/2011,2011-01-01 00:00:00,Liverpool,Bolton Wanderers,2,1,1.7,3.75,5.0,10,6,10,7,13,15,2,2,0,0,22,12,7,4,56.0,44.0,3,16,17,28,4,0,34,11
951,2620,21,2010/2011,2011-01-01 00:00:00,Sunderland,Blackburn Rovers,3,0,1.83,3.5,4.5,6,4,7,7,12,10,1,2,0,0,21,17,3,2,51.0,49.0,3,10,14,22,3,0,38,5
952,2621,21,2010/2011,2011-01-01 00:00:00,Tottenham Hotspur,Fulham,1,0,1.4,4.5,8.5,7,5,5,7,11,11,2,1,0,0,8,16,5,1,54.0,46.0,1,12,12,22,3,0,24,6
953,2622,21,2010/2011,2011-01-01 00:00:00,West Ham United,Wolverhampton Wanderers,2,0,2.0,3.4,3.8,4,7,6,5,7,15,1,1,0,0,16,17,5,10,49.0,51.0,2,11,11,22,2,0,33,15
954,2623,21,2010/2011,2011-01-01 00:00:00,Manchester City,Blackpool,1,0,1.29,5.5,10.0,9,8,11,2,12,10,0,0,0,0,23,15,10,4,56.0,44.0,1,17,13,22,0,0,38,14
955,2624,21,2010/2011,2011-01-01 00:00:00,Birmingham City,Arsenal,0,3,5.5,3.6,1.67,1,10,3,6,8,6,3,1,0,0,7,5,4,5,48.0,52.0,3,11,9,14,4,0,12,9
956,2625,21,2010/2011,2011-01-01 00:00:00,West Bromwich Albion,Manchester United,1,2,6.0,4.2,1.53,8,1,10,2,9,15,1,3,0,0,12,12,4,5,47.0,53.0,3,9,12,24,4,0,24,9
957,2626,21,2010/2011,2011-01-01 00:00:00,Stoke City,Everton,2,0,2.63,3.2,2.75,3,6,5,9,11,8,4,1,0,0,10,18,1,5,38.0,62.0,2,9,14,19,5,0,28,6
958,2627,21,2010/2011,2011-01-02 00:00:00,Wigan Athletic,Newcastle United,0,1,2.5,3.2,2.9,3,4,7,12,14,15,2,2,0,0,12,13,3,3,52.0,48.0,1,7,19,29,4,0,25,6
959,2628,21,2010/2011,2011-01-02 00:00:00,Chelsea,Aston Villa,3,3,1.25,5.5,13.0,8,6,7,6,16,12,2,7,0,0,22,13,9,6,60.0,40.0,6,14,13,28,9,0,35,15
960,2629,22,2010/2011,2011-01-04 00:00:00,Manchester United,Stoke City,2,1,1.25,5.75,12.0,7,0,14,4,6,11,0,0,0,0,25,16,6,1,56.0,44.0,3,7,18,17,0,0,41,7
961,2633,22,2010/2011,2011-01-04 00:00:00,Blackpool,Birmingham City,1,2,2.3,3.25,3.25,11,5,9,7,10,7,0,1,0,0,24,13,3,7,61.0,39.0,3,16,16,17,1,0,37,10
962,2638,22,2010/2011,2011-01-04 00:00:00,Fulham,West Bromwich Albion,3,0,2.2,3.25,3.4,5,6,6,8,7,10,0,1,0,0,26,16,7,4,59.0,41.0,3,11,14,17,1,0,42,11
963,2630,22,2010/2011,2011-01-05 00:00:00,Arsenal,Manchester City,0,0,1.91,3.6,4.0,10,2,7,4,6,12,0,2,1,1,22,7,7,2,61.0,39.0,0,12,11,18,2,2,29,9
964,2631,22,2010/2011,2011-01-05 00:00:00,Wolverhampton Wanderers,Chelsea,1,0,8.0,4.2,1.44,2,9,1,10,16,13,0,1,0,0,13,38,4,9,47.0,53.0,1,11,11,29,1,0,51,13
965,2632,22,2010/2011,2011-01-05 00:00:00,Bolton Wanderers,Wigan Athletic,1,1,1.73,3.6,5.0,5,4,8,2,11,10,0,4,0,0,35,8,9,5,49.0,51.0,2,9,10,21,4,0,43,14
966,2634,22,2010/2011,2011-01-05 00:00:00,Aston Villa,Sunderland,0,1,2.2,3.25,3.4,5,5,5,6,9,13,3,3,1,0,23,25,5,9,57.0,43.0,1,10,11,22,6,1,48,14
967,2635,22,2010/2011,2011-01-05 00:00:00,Everton,Tottenham Hotspur,2,1,2.63,3.25,2.75,14,6,4,6,18,13,1,0,0,0,21,18,4,3,58.0,42.0,3,20,10,31,1,0,39,7
968,2636,22,2010/2011,2011-01-05 00:00:00,Newcastle United,West Ham United,5,0,1.83,3.6,4.33,4,5,5,6,13,12,0,4,0,0,27,10,4,3,54.0,46.0,5,9,11,25,4,0,37,7
969,2637,22,2010/2011,2011-01-05 00:00:00,Blackburn Rovers,Liverpool,3,1,3.4,3.25,2.2,4,4,4,7,11,10,2,1,0,0,22,55,0,7,52.0,48.0,4,8,11,21,3,0,77,7
970,2598,19,2010/2011,2011-01-12 00:00:00,Blackpool,Liverpool,2,1,3.8,3.75,1.91,4,8,4,4,10,14,1,3,0,0,19,23,3,3,52.0,48.0,3,12,8,24,4,0,42,6
971,2642,23,2010/2011,2011-01-15 00:00:00,West Ham United,Arsenal,0,3,6.0,4.0,1.57,5,10,3,8,9,8,1,0,0,0,9,16,4,10,39.0,61.0,3,15,11,17,1,0,25,14
972,2643,23,2010/2011,2011-01-15 00:00:00,Manchester City,Wolverhampton Wanderers,4,3,1.33,5.0,10.0,10,5,2,3,11,10,0,0,0,0,50,34,9,9,55.0,45.0,7,15,5,21,0,0,84,18
973,2645,23,2010/2011,2011-01-15 00:00:00,West Bromwich Albion,Blackpool,3,2,1.8,3.6,4.5,9,0,8,7,9,14,1,2,0,0,22,14,4,4,55.0,45.0,5,9,15,23,3,0,36,8
974,2646,23,2010/2011,2011-01-15 00:00:00,Stoke City,Bolton Wanderers,2,0,2.1,3.25,3.75,4,5,6,8,8,13,0,2,0,0,32,22,5,5,51.0,49.0,2,9,14,21,2,0,54,10
975,2647,23,2010/2011,2011-01-15 00:00:00,Wigan Athletic,Fulham,1,1,2.5,3.25,2.88,3,5,3,7,17,9,4,2,0,0,10,19,2,9,40.0,60.0,2,8,10,26,6,0,29,11
976,2648,23,2010/2011,2011-01-15 00:00:00,Chelsea,Blackburn Rovers,2,0,1.29,5.5,11.0,8,4,15,1,11,8,1,0,0,0,44,13,14,1,59.0,41.0,2,12,16,19,1,0,57,15
977,2639,23,2010/2011,2011-01-16 00:00:00,Liverpool,Everton,2,2,2.2,3.2,3.5,14,4,4,5,17,18,3,0,0,0,24,18,10,6,52.0,48.0,4,18,9,35,3,0,42,16
978,2640,23,2010/2011,2011-01-16 00:00:00,Sunderland,Newcastle United,1,1,2.2,3.25,3.4,6,2,4,7,17,7,1,1,0,0,20,17,5,6,51.0,49.0,2,8,11,24,2,0,37,11
979,2641,23,2010/2011,2011-01-16 00:00:00,Tottenham Hotspur,Manchester United,0,0,2.88,3.3,2.5,10,3,12,4,9,20,2,4,0,0,34,14,8,2,58.0,42.0,0,13,16,29,6,0,48,10
980,2644,23,2010/2011,2011-01-16 00:00:00,Birmingham City,Aston Villa,1,1,2.4,3.2,3.1,9,4,7,13,14,14,1,2,0,0,15,23,5,7,48.0,52.0,2,13,20,28,3,0,38,12
981,2649,24,2010/2011,2011-01-22 00:00:00,Manchester United,Birmingham City,5,0,1.2,6.5,15.0,4,2,13,4,11,5,0,0,0,0,37,16,10,3,57.0,43.0,5,6,17,16,0,0,53,13
982,2650,24,2010/2011,2011-01-22 00:00:00,Arsenal,Wigan Athletic,3,0,1.2,6.5,15.0,12,1,7,2,5,11,0,1,0,1,21,8,8,1,58.0,42.0,3,13,9,16,1,1,29,9
983,2651,24,2010/2011,2011-01-22 00:00:00,Aston Villa,Manchester City,1,0,3.5,3.4,2.1,7,10,2,11,6,10,1,1,0,0,18,32,2,13,45.0,55.0,1,17,13,16,2,0,50,15
984,2652,24,2010/2011,2011-01-22 00:00:00,Everton,West Ham United,2,2,1.5,4.0,7.5,5,4,5,8,8,12,1,2,0,0,38,10,12,2,58.0,42.0,4,9,13,20,3,0,48,14
985,2653,24,2010/2011,2011-01-22 00:00:00,Newcastle United,Tottenham Hotspur,1,1,3.5,3.4,2.1,5,7,7,6,11,7,0,0,0,0,11,15,1,4,61.0,39.0,2,12,13,18,0,0,26,5
986,2654,24,2010/2011,2011-01-22 00:00:00,Wolverhampton Wanderers,Liverpool,0,3,3.4,3.2,2.25,5,7,10,6,7,18,0,3,0,0,33,15,5,4,48.0,52.0,3,12,16,25,3,0,48,9
987,2656,24,2010/2011,2011-01-22 00:00:00,Fulham,Stoke City,2,0,2.2,3.2,3.5,8,2,4,7,10,10,1,1,0,1,14,9,3,2,65.0,35.0,2,10,11,20,2,1,23,5
988,2658,24,2010/2011,2011-01-22 00:00:00,Blackpool,Sunderland,1,2,2.5,3.25,2.88,9,5,7,7,15,15,2,0,0,0,18,14,10,4,46.0,54.0,3,14,14,30,2,0,32,14
989,2655,24,2010/2011,2011-01-23 00:00:00,Blackburn Rovers,West Bromwich Albion,2,0,2.25,3.3,3.25,9,14,3,4,5,6,0,1,0,0,27,20,8,9,52.0,48.0,2,23,7,11,1,0,47,17
990,2657,24,2010/2011,2011-01-24 00:00:00,Bolton Wanderers,Chelsea,0,4,6.0,3.75,1.62,7,8,4,4,8,5,0,0,0,0,15,9,4,3,38.0,62.0,4,15,8,13,0,0,24,7
991,2566,16,2010/2011,2011-01-25 00:00:00,Blackpool,Manchester United,2,3,8.0,5.0,1.36,2,11,4,6,10,10,1,2,0,0,21,38,6,8,47.0,53.0,5,13,10,20,3,0,59,14
992,2587,18,2010/2011,2011-01-25 00:00:00,Wigan Athletic,Aston Villa,1,2,3.2,3.25,2.3,9,9,13,2,9,13,2,3,0,0,25,20,7,4,43.0,57.0,3,18,15,22,5,0,45,11
993,2580,18,2010/2011,2011-01-26 00:00:00,Liverpool,Fulham,1,0,1.53,3.8,7.0,6,8,7,4,11,13,0,1,0,0,25,16,6,2,55.0,45.0,1,14,11,24,1,0,41,8
994,2659,25,2010/2011,2011-02-01 00:00:00,Manchester United,Aston Villa,3,1,1.33,5.0,9.5,11,5,8,5,7,7,0,0,0,0,23,22,5,5,50.0,50.0,4,16,13,14,0,0,45,10
995,2660,25,2010/2011,2011-02-01 00:00:00,Arsenal,Everton,2,1,1.4,4.5,8.5,5,6,11,1,11,15,3,5,0,0,12,21,5,7,55.0,45.0,3,11,12,26,8,0,33,12
996,2661,25,2010/2011,2011-02-01 00:00:00,Sunderland,Chelsea,2,4,5.5,3.6,1.67,3,12,2,8,6,9,1,2,0,0,4,14,0,6,37.0,63.0,6,15,10,15,3,0,18,6
997,2664,25,2010/2011,2011-02-01 00:00:00,West Bromwich Albion,Wigan Athletic,2,2,1.73,3.6,5.0,7,4,11,5,13,13,4,5,0,0,13,8,8,5,40.0,60.0,4,11,16,26,9,0,21,13
998,2662,25,2010/2011,2011-02-02 00:00:00,Birmingham City,Manchester City,2,2,4.5,3.5,1.83,7,8,7,4,8,12,0,2,0,0,30,19,6,4,50.0,50.0,4,15,11,20,2,0,49,10
999,2663,25,2010/2011,2011-02-02 00:00:00,Bolton Wanderers,Wolverhampton Wanderers,1,0,1.83,3.5,4.5,6,5,8,8,14,9,1,3,0,0,43,22,8,3,51.0,49.0,1,11,16,23,4,0,65,11
1000,2665,25,2010/2011,2011-02-02 00:00:00,Blackpool,West Ham United,1,3,2.38,3.3,3.0,10,7,10,3,10,14,0,1,0,0,25,13,10,7,48.0,52.0,4,17,13,24,1,0,38,17
1001,2666,25,2010/2011,2011-02-02 00:00:00,Liverpool,Stoke City,2,0,1.62,3.75,6.0,9,2,5,5,6,9,1,4,0,0,12,8,7,0,60.0,40.0,2,11,10,15,5,0,20,7
1002,2667,25,2010/2011,2011-02-02 00:00:00,Blackburn Rovers,Tottenham Hotspur,0,1,3.25,3.4,2.2,13,3,5,1,15,10,2,1,0,0,19,15,4,4,49.0,51.0,1,16,6,25,3,0,34,8
1003,2668,25,2010/2011,2011-02-02 00:00:00,Fulham,Newcastle United,1,0,2.1,3.3,3.6,13,2,2,3,15,18,0,3,0,0,15,19,5,7,52.0,48.0,1,15,5,33,3,0,34,12
1004,2669,26,2010/2011,2011-02-05 00:00:00,Tottenham Hotspur,Bolton Wanderers,2,1,1.57,4.0,6.0,8,5,7,6,11,15,1,3,0,0,24,21,6,7,45.0,55.0,3,13,13,26,4,0,45,13
1005,2671,26,2010/2011,2011-02-05 00:00:00,Aston Villa,Fulham,2,2,1.91,3.4,4.2,5,8,4,4,14,12,3,2,0,0,15,18,3,6,59.0,41.0,4,13,8,26,5,0,33,9
1006,2672,26,2010/2011,2011-02-05 00:00:00,Everton,Blackpool,5,3,1.44,4.5,7.0,12,6,8,4,10,16,0,1,0,0,15,12,9,5,50.0,50.0,8,18,12,26,1,0,27,14
1007,2673,26,2010/2011,2011-02-05 00:00:00,Newcastle United,Arsenal,4,4,5.0,4.0,1.67,9,5,9,2,14,12,2,3,0,1,33,8,12,6,55.0,45.0,8,14,11,26,5,1,41,18
1008,2674,26,2010/2011,2011-02-05 00:00:00,Manchester City,West Bromwich Albion,3,0,1.4,4.5,8.5,8,7,7,9,12,10,1,2,0,0,7,13,8,8,53.0,47.0,3,15,16,22,3,0,20,16
1009,2675,26,2010/2011,2011-02-05 00:00:00,Wolverhampton Wanderers,Manchester United,2,1,8.5,4.5,1.4,4,5,2,10,10,13,2,2,0,0,15,37,4,6,45.0,55.0,3,9,12,23,4,0,52,10
1010,2676,26,2010/2011,2011-02-05 00:00:00,Stoke City,Sunderland,3,2,2.1,3.2,3.75,4,6,12,4,7,14,1,3,0,0,42,12,12,4,48.0,52.0,5,10,16,21,4,0,54,16
1011,2677,26,2010/2011,2011-02-05 00:00:00,Wigan Athletic,Blackburn Rovers,4,3,2.5,3.25,2.9,4,5,4,4,8,10,1,2,0,0,9,21,4,9,58.0,42.0,7,9,8,18,3,0,30,13
1012,2670,26,2010/2011,2011-02-06 00:00:00,West Ham United,Birmingham City,0,1,2.0,3.5,3.75,8,2,8,6,18,11,3,1,0,0,28,18,5,5,53.0,47.0,1,10,14,29,4,0,46,10
1013,2678,26,2010/2011,2011-02-06 00:00:00,Chelsea,Liverpool,0,1,1.62,4.0,5.5,5,3,13,2,7,8,1,1,0,0,15,14,4,3,52.0,48.0,1,8,15,15,2,0,29,7
1014,2679,27,2010/2011,2011-02-12 00:00:00,Manchester United,Manchester City,2,1,1.73,3.6,5.0,3,8,6,5,16,12,2,2,0,0,24,21,4,7,52.0,48.0,3,11,11,28,4,0,45,11
1015,2680,27,2010/2011,2011-02-12 00:00:00,Arsenal,Wolverhampton Wanderers,2,0,1.22,6.0,15.0,8,1,8,2,14,9,0,1,0,0,47,28,3,6,56.0,44.0,2,9,10,23,1,0,75,9
1016,2681,27,2010/2011,2011-02-12 00:00:00,Liverpool,Wigan Athletic,1,1,1.36,4.75,9.0,9,6,8,5,11,15,1,3,0,0,19,16,8,5,54.0,46.0,2,15,13,26,4,0,35,13
1017,2682,27,2010/2011,2011-02-12 00:00:00,Sunderland,Tottenham Hotspur,1,2,2.75,3.25,2.6,8,4,8,6,13,14,2,4,0,0,9,14,2,3,52.0,48.0,3,12,14,27,6,0,23,5
1018,2683,27,2010/2011,2011-02-12 00:00:00,Blackburn Rovers,Newcastle United,0,0,2.1,3.4,3.5,2,7,5,6,9,11,1,3,0,0,14,42,2,11,43.0,57.0,0,9,11,20,4,0,56,13
1019,2685,27,2010/2011,2011-02-12 00:00:00,Birmingham City,Stoke City,1,0,2.5,3.2,2.9,4,6,5,9,11,15,1,0,0,0,19,18,2,6,52.0,48.0,1,10,14,26,1,0,37,8
1020,2687,27,2010/2011,2011-02-12 00:00:00,West Bromwich Albion,West Ham United,3,3,1.91,3.6,4.0,11,4,4,10,12,12,2,3,0,0,8,14,4,9,47.0,53.0,6,15,14,24,5,0,22,13
1021,2688,27,2010/2011,2011-02-12 00:00:00,Blackpool,Aston Villa,1,1,3.25,3.4,2.2,4,3,11,3,12,13,2,1,0,1,18,31,3,8,48.0,52.0,2,7,14,25,3,1,49,11
1022,2686,27,2010/2011,2011-02-13 00:00:00,Bolton Wanderers,Everton,2,0,2.75,3.25,2.6,2,3,6,6,14,10,1,0,0,0,17,28,4,4,46.0,54.0,2,5,12,24,1,0,45,8
1023,2684,27,2010/2011,2011-02-14 00:00:00,Fulham,Chelsea,0,0,5.0,3.6,1.73,4,8,6,19,8,13,2,1,0,0,10,19,4,6,39.0,61.0,0,12,25,21,3,0,29,10
1024,2584,18,2010/2011,2011-02-15 00:00:00,Birmingham City,Newcastle United,0,2,2.6,3.2,2.8,5,4,8,5,13,14,1,3,0,0,21,18,4,6,46.0,54.0,2,9,13,27,4,0,39,10
1025,2585,18,2010/2011,2011-02-20 00:00:00,West Bromwich Albion,Wolverhampton Wanderers,1,1,1.85,3.4,4.5,11,1,8,4,8,6,0,0,0,0,35,15,12,1,51.0,49.0,2,12,12,14,0,0,50,13
1026,2586,18,2010/2011,2011-02-22 00:00:00,Blackpool,Tottenham Hotspur,3,1,4.0,3.6,1.91,2,11,4,15,12,9,2,0,0,0,7,30,1,7,41.0,59.0,4,13,19,21,2,0,37,8
1027,2579,18,2010/2011,2011-02-23 00:00:00,Arsenal,Stoke City,1,0,1.3,5.25,10.0,5,3,5,3,9,11,1,2,0,0,28,25,5,3,55.0,45.0,1,8,8,20,3,0,53,8
1028,2691,28,2010/2011,2011-02-26 00:00:00,Aston Villa,Blackburn Rovers,4,1,1.73,3.6,5.0,8,1,9,3,4,12,0,3,0,0,14,5,10,2,61.0,39.0,5,9,12,16,3,0,19,12
1029,2692,28,2010/2011,2011-02-26 00:00:00,Everton,Sunderland,2,0,1.73,3.6,5.0,9,7,6,5,11,10,0,0,0,0,31,18,4,1,58.0,42.0,2,16,11,21,0,0,49,5
1030,2693,28,2010/2011,2011-02-26 00:00:00,Newcastle United,Bolton Wanderers,1,1,2.1,3.25,3.75,5,9,8,11,10,13,0,2,1,0,20,24,3,6,43.0,57.0,2,14,19,23,2,1,44,9
1031,2695,28,2010/2011,2011-02-26 00:00:00,Wolverhampton Wanderers,Blackpool,4,0,1.83,3.6,4.33,4,1,7,2,15,9,1,1,0,1,33,6,10,4,60.0,40.0,4,5,9,24,2,1,39,14
1032,2697,28,2010/2011,2011-02-26 00:00:00,Wigan Athletic,Manchester United,0,4,6.5,4.0,1.53,5,7,5,8,15,11,0,1,0,0,31,17,8,3,40.0,60.0,4,12,13,26,1,0,48,11
1033,2690,28,2010/2011,2011-02-27 00:00:00,West Ham United,Liverpool,3,1,3.4,3.3,2.2,10,10,6,4,10,8,0,1,0,0,15,22,6,9,53.0,47.0,4,20,10,18,1,0,37,15
1034,2694,28,2010/2011,2011-02-27 00:00:00,Manchester City,Fulham,1,1,1.5,4.0,7.5,4,3,8,5,14,10,1,2,0,0,29,19,9,1,49.0,51.0,2,7,13,24,3,0,48,10
1035,2696,28,2010/2011,2011-02-28 00:00:00,Stoke City,West Bromwich Albion,1,1,1.91,3.4,4.2,3,14,3,5,13,17,2,2,0,0,19,8,4,0,47.0,53.0,2,17,8,30,4,0,27,4
1036,2588,18,2010/2011,2011-03-01 00:00:00,Chelsea,Manchester United,2,1,2.2,3.2,3.6,6,6,14,5,10,14,3,2,0,0,33,19,10,2,51.0,49.0,3,12,19,24,5,0,52,12
1037,2699,29,2010/2011,2011-03-05 00:00:00,Arsenal,Sunderland,0,0,1.44,4.33,7.5,9,5,7,3,11,9,3,3,0,0,45,20,5,6,60.0,40.0,0,14,10,20,6,0,65,11
1038,2701,29,2010/2011,2011-03-05 00:00:00,West Ham United,Stoke City,3,0,2.25,3.3,3.25,6,5,8,2,13,9,0,3,0,0,8,14,6,3,58.0,42.0,3,11,10,22,3,0,22,9
1039,2702,29,2010/2011,2011-03-05 00:00:00,Newcastle United,Everton,1,2,2.6,3.2,2.8,8,7,4,5,12,13,2,4,0,0,33,17,5,4,60.0,40.0,3,15,9,25,6,0,50,9
1040,2703,29,2010/2011,2011-03-05 00:00:00,Manchester City,Wigan Athletic,1,0,1.36,4.75,9.0,3,4,4,8,16,9,3,1,0,0,18,22,4,6,44.0,56.0,1,7,12,25,4,0,40,10
1041,2705,29,2010/2011,2011-03-05 00:00:00,Fulham,Blackburn Rovers,3,2,1.73,3.6,5.0,8,6,5,4,12,14,2,3,0,1,24,21,9,7,52.0,48.0,5,14,9,26,5,1,45,16
1042,2706,29,2010/2011,2011-03-05 00:00:00,Birmingham City,West Bromwich Albion,1,3,2.38,3.2,3.1,6,4,5,4,9,9,3,1,0,0,23,11,7,3,52.0,48.0,4,10,9,18,4,0,34,10
1043,2707,29,2010/2011,2011-03-05 00:00:00,Bolton Wanderers,Aston Villa,3,2,2.25,3.4,3.2,7,6,5,5,19,12,5,2,0,0,29,17,9,5,57.0,43.0,5,13,10,31,7,0,46,14
1044,2700,29,2010/2011,2011-03-06 00:00:00,Liverpool,Manchester United,3,1,2.8,3.2,2.6,7,6,9,6,11,13,2,3,0,0,19,25,6,4,52.0,48.0,4,13,15,24,5,0,44,10
1045,2704,29,2010/2011,2011-03-06 00:00:00,Wolverhampton Wanderers,Tottenham Hotspur,3,3,3.0,3.3,2.38,5,10,9,7,11,10,0,3,0,0,25,19,7,4,44.0,56.0,6,15,16,21,3,0,44,11
1046,2708,29,2010/2011,2011-03-07 00:00:00,Blackpool,Chelsea,1,3,10.0,5.5,1.3,5,11,9,6,3,7,0,0,0,0,22,25,3,13,42.0,58.0,4,16,15,10,0,0,47,16
1047,2592,19,2010/2011,2011-03-09 00:00:00,Everton,Birmingham City,1,1,1.53,4.0,6.5,16,2,5,3,8,14,1,3,0,0,36,6,9,1,58.0,42.0,2,18,8,22,4,0,42,10
1048,2719,30,2010/2011,2011-03-19 00:00:00,Manchester United,Bolton Wanderers,1,0,1.36,4.75,9.0,9,6,8,11,8,11,0,0,1,0,31,17,12,5,60.0,40.0,1,15,19,19,0,1,48,17
1049,2721,30,2010/2011,2011-03-19 00:00:00,Tottenham Hotspur,West Ham United,0,0,1.57,4.0,6.0,18,7,12,5,6,14,0,4,0,0,19,9,6,2,52.0,48.0,0,25,17,20,4,0,28,8
1050,2722,30,2010/2011,2011-03-19 00:00:00,Aston Villa,Wolverhampton Wanderers,0,1,1.83,3.5,4.5,8,5,5,4,14,15,1,3,0,0,29,6,9,3,52.0,48.0,1,13,9,29,4,0,35,12
1051,2723,30,2010/2011,2011-03-19 00:00:00,Everton,Fulham,2,1,2.0,3.25,4.0,9,5,3,7,14,18,2,0,0,0,23,14,7,5,53.0,47.0,3,14,10,32,2,0,37,12
1052,2724,30,2010/2011,2011-03-19 00:00:00,Blackburn Rovers,Blackpool,2,2,1.8,3.6,4.5,6,5,16,3,18,12,1,1,0,0,52,9,8,3,55.0,45.0,4,11,19,30,2,0,61,11
1053,2725,30,2010/2011,2011-03-19 00:00:00,West Bromwich Albion,Arsenal,2,2,5.0,3.6,1.73,1,9,1,7,12,7,1,3,0,0,8,35,2,7,35.0,65.0,4,10,8,19,4,0,43,9
1054,2726,30,2010/2011,2011-03-19 00:00:00,Stoke City,Newcastle United,4,0,2.2,3.25,3.4,1,9,2,6,18,11,1,1,0,0,19,28,3,7,42.0,58.0,4,10,8,29,2,0,47,10
1055,2727,30,2010/2011,2011-03-19 00:00:00,Wigan Athletic,Birmingham City,2,1,2.1,3.3,3.6,15,5,3,3,13,11,3,1,0,0,21,9,9,4,54.0,46.0,3,20,6,24,4,0,30,13
1056,2720,30,2010/2011,2011-03-20 00:00:00,Sunderland,Liverpool,0,2,2.63,3.2,2.75,3,5,3,5,11,9,3,3,1,0,18,12,3,6,46.0,54.0,2,8,8,20,6,1,30,9
1057,2728,30,2010/2011,2011-03-20 00:00:00,Chelsea,Manchester City,2,0,1.62,3.75,6.0,9,2,7,2,10,12,2,4,0,0,19,8,5,1,51.0,49.0,2,11,9,22,6,0,27,6
1058,2729,31,2010/2011,2011-04-02 00:00:00,Arsenal,Blackburn Rovers,0,0,1.25,6.0,11.0,12,2,8,5,9,6,1,2,0,1,33,12,11,4,56.0,44.0,0,14,13,15,3,1,45,15
1059,2730,31,2010/2011,2011-04-02 00:00:00,West Ham United,Manchester United,2,4,4.5,3.6,1.8,2,8,4,13,12,10,1,2,0,0,13,45,0,16,36.0,64.0,6,10,17,22,3,0,58,16
1060,2731,31,2010/2011,2011-04-02 00:00:00,Everton,Aston Villa,2,2,1.83,3.6,4.33,7,4,8,4,13,16,3,2,0,0,20,21,5,7,54.0,46.0,4,11,12,29,5,0,41,12
1061,2732,31,2010/2011,2011-04-02 00:00:00,Newcastle United,Wolverhampton Wanderers,4,1,1.95,3.4,4.0,8,11,5,5,19,10,5,3,0,0,25,23,5,4,60.0,40.0,5,19,10,29,8,0,48,9
1062,2735,31,2010/2011,2011-04-02 00:00:00,Birmingham City,Bolton Wanderers,2,1,2.5,3.25,2.88,5,13,5,5,12,15,0,2,0,0,22,39,8,9,46.0,54.0,3,18,10,27,2,0,61,17
1063,2736,31,2010/2011,2011-04-02 00:00:00,West Bromwich Albion,Liverpool,2,1,3.0,3.3,2.38,12,9,5,6,9,14,2,3,0,0,15,14,0,5,51.0,49.0,3,21,11,23,5,0,29,5
1064,2737,31,2010/2011,2011-04-02 00:00:00,Stoke City,Chelsea,1,1,5.5,3.6,1.67,5,13,9,10,6,11,1,2,0,0,18,36,5,12,35.0,65.0,2,18,19,17,3,0,54,17
1065,2738,31,2010/2011,2011-04-02 00:00:00,Wigan Athletic,Tottenham Hotspur,0,0,3.0,3.25,2.4,4,6,13,7,11,8,1,1,0,0,14,7,8,2,47.0,53.0,0,10,20,19,2,0,21,10
1066,2733,31,2010/2011,2011-04-03 00:00:00,Manchester City,Sunderland,5,0,1.5,4.0,7.0,9,4,3,5,8,20,2,3,0,0,15,21,6,5,51.0,49.0,5,13,8,28,5,0,36,11
1067,2734,31,2010/2011,2011-04-03 00:00:00,Fulham,Blackpool,3,0,1.53,4.2,6.0,7,7,7,6,16,6,2,1,0,0,13,16,4,7,49.0,51.0,3,14,13,22,3,0,29,11
1068,2739,32,2010/2011,2011-04-09 00:00:00,Manchester United,Fulham,2,0,1.44,4.33,7.5,8,4,7,10,12,8,0,0,0,0,19,17,8,3,54.0,46.0,2,12,17,20,0,0,36,11
1069,2741,32,2010/2011,2011-04-09 00:00:00,Sunderland,West Bromwich Albion,2,3,2.2,3.2,3.5,1,4,4,2,8,11,3,1,0,0,10,6,5,2,48.0,52.0,5,5,6,19,4,0,16,7
1070,2742,32,2010/2011,2011-04-09 00:00:00,Tottenham Hotspur,Stoke City,3,2,1.73,3.6,5.0,8,6,3,3,13,16,1,3,0,0,31,21,10,5,55.0,45.0,5,14,6,29,4,0,52,15
1071,2744,32,2010/2011,2011-04-09 00:00:00,Wolverhampton Wanderers,Everton,0,3,2.6,3.25,2.8,7,3,7,6,16,13,0,1,0,0,40,18,13,5,55.0,45.0,3,10,13,29,1,0,58,18
1072,2745,32,2010/2011,2011-04-09 00:00:00,Blackburn Rovers,Birmingham City,1,1,2.0,3.3,4.0,6,2,12,3,9,10,2,3,0,0,24,6,7,2,51.0,49.0,2,8,15,19,5,0,30,9
1073,2746,32,2010/2011,2011-04-09 00:00:00,Bolton Wanderers,West Ham United,3,0,2.2,3.25,3.4,7,6,13,8,4,10,1,0,0,0,30,37,5,10,60.0,40.0,3,13,21,14,1,0,67,15
1074,2748,32,2010/2011,2011-04-09 00:00:00,Chelsea,Wigan Athletic,1,0,1.2,6.0,17.0,8,7,9,5,10,10,1,2,0,0,26,17,10,5,60.0,40.0,1,15,14,20,3,0,43,15
1075,2743,32,2010/2011,2011-04-10 00:00:00,Aston Villa,Newcastle United,1,0,1.83,3.6,4.33,5,5,8,3,9,11,2,2,0,0,21,18,9,2,48.0,52.0,1,10,11,20,4,0,39,11
1076,2747,32,2010/2011,2011-04-10 00:00:00,Blackpool,Arsenal,1,3,8.5,5.0,1.36,5,3,8,10,13,9,2,2,0,0,21,21,6,4,41.0,59.0,4,8,18,22,4,0,42,10
1077,2740,32,2010/2011,2011-04-11 00:00:00,Liverpool,Manchester City,3,0,2.6,3.2,2.8,7,4,9,9,6,3,1,0,0,0,24,14,6,2,53.0,47.0,3,11,18,9,1,0,38,8
1078,2749,33,2010/2011,2011-04-16 00:00:00,Blackpool,Wigan Athletic,1,3,2.3,3.5,3.0,5,3,6,4,12,7,2,2,0,0,20,8,5,3,51.0,49.0,4,8,10,19,4,0,28,8
1079,2751,33,2010/2011,2011-04-16 00:00:00,West Ham United,Aston Villa,1,2,2.25,3.3,3.25,10,7,4,13,7,3,0,0,0,0,23,33,5,11,47.0,53.0,3,17,17,10,0,0,56,16
1080,2752,33,2010/2011,2011-04-16 00:00:00,Everton,Blackburn Rovers,2,0,1.67,3.75,5.5,6,3,10,2,10,16,2,3,0,0,28,12,10,1,54.0,46.0,2,9,12,26,5,0,40,11
1081,2756,33,2010/2011,2011-04-16 00:00:00,Birmingham City,Sunderland,2,0,2.25,3.2,3.4,1,8,6,11,1,6,0,0,0,0,8,15,4,9,45.0,55.0,2,9,17,7,0,0,23,13
1082,2757,33,2010/2011,2011-04-16 00:00:00,West Bromwich Albion,Chelsea,1,3,5.5,3.6,1.7,4,8,10,11,7,9,1,0,0,0,15,33,3,5,40.0,60.0,4,12,21,16,1,0,48,8
1083,2750,33,2010/2011,2011-04-17 00:00:00,Arsenal,Liverpool,1,1,1.73,3.6,5.0,7,4,9,4,13,10,2,4,0,0,35,12,10,3,55.0,45.0,2,11,13,23,6,0,47,13
1084,2753,33,2010/2011,2011-04-19 00:00:00,Newcastle United,Manchester United,0,0,5.5,3.6,1.67,5,9,10,11,10,10,2,2,0,0,23,26,6,7,48.0,52.0,0,14,21,20,4,0,49,13
1085,2689,28,2010/2011,2011-04-20 00:00:00,Tottenham Hotspur,Arsenal,3,3,2.88,3.4,2.4,8,8,6,3,8,15,0,3,0,0,28,13,7,6,57.0,43.0,6,16,9,23,3,0,41,13
1086,2698,28,2010/2011,2011-04-20 00:00:00,Chelsea,Birmingham City,3,1,1.2,6.5,15.0,6,4,9,3,8,7,0,1,0,0,21,8,7,4,53.0,47.0,4,10,12,15,1,0,29,11
1087,2759,34,2010/2011,2011-04-23 00:00:00,Manchester United,Everton,1,0,1.44,4.33,7.5,11,4,10,2,11,10,1,2,0,0,46,12,13,1,61.0,39.0,1,15,12,21,3,0,58,14
1088,2760,34,2010/2011,2011-04-23 00:00:00,Liverpool,Birmingham City,5,0,1.44,4.33,7.5,11,4,4,6,7,13,1,0,0,0,20,17,5,2,52.0,48.0,5,15,10,20,1,0,37,7
1089,2761,34,2010/2011,2011-04-23 00:00:00,Sunderland,Wigan Athletic,4,2,2.1,3.25,3.75,3,7,5,3,11,11,1,2,0,0,27,10,7,3,55.0,45.0,6,10,8,22,3,0,37,10
1090,2762,34,2010/2011,2011-04-23 00:00:00,Tottenham Hotspur,West Bromwich Albion,2,2,1.57,4.0,6.0,11,3,8,6,8,13,1,1,0,0,25,2,11,1,53.0,47.0,4,14,14,21,2,0,27,12
1091,2763,34,2010/2011,2011-04-23 00:00:00,Aston Villa,Stoke City,1,1,1.8,3.6,4.5,3,3,6,1,10,9,0,3,0,0,35,29,7,8,52.0,48.0,2,6,7,19,3,0,64,15
1092,2764,34,2010/2011,2011-04-23 00:00:00,Wolverhampton Wanderers,Fulham,1,1,2.5,3.25,2.88,2,7,7,10,15,21,2,2,0,0,21,31,3,5,47.0,53.0,2,9,17,36,4,0,52,8
1093,2767,34,2010/2011,2011-04-23 00:00:00,Blackpool,Newcastle United,1,1,2.88,3.5,2.38,6,7,9,3,16,5,1,1,0,0,22,8,5,4,57.0,43.0,2,13,12,21,2,0,30,9
1094,2768,34,2010/2011,2011-04-23 00:00:00,Chelsea,West Ham United,3,0,1.2,6.5,15.0,10,11,6,5,7,13,1,2,0,0,17,18,5,7,59.0,41.0,3,21,11,20,3,0,35,12
1095,2766,34,2010/2011,2011-04-24 00:00:00,Bolton Wanderers,Arsenal,2,1,4.5,3.8,1.75,5,10,3,6,14,15,4,3,0,0,13,33,3,9,42.0,58.0,3,15,9,29,7,0,46,12
1096,2765,34,2010/2011,2011-04-25 00:00:00,Blackburn Rovers,Manchester City,0,1,3.6,3.3,2.1,7,7,9,5,15,15,2,3,0,0,21,21,4,6,52.0,48.0,1,14,14,30,5,0,42,10
1097,2758,33,2010/2011,2011-04-26 00:00:00,Stoke City,Wolverhampton Wanderers,3,0,1.8,3.4,5.0,5,1,8,7,13,13,3,2,0,0,29,22,7,10,54.0,46.0,3,6,15,26,5,0,51,17
1098,2755,33,2010/2011,2011-04-27 00:00:00,Fulham,Bolton Wanderers,3,0,1.8,3.5,4.75,3,7,14,9,15,10,1,1,0,0,23,21,10,7,50.0,50.0,3,10,23,25,2,0,44,17
1099,2771,35,2010/2011,2011-04-30 00:00:00,Sunderland,Fulham,0,3,2.6,3.2,2.8,6,2,4,3,6,10,1,0,0,0,12,8,5,4,53.0,47.0,3,8,7,16,1,0,20,9
1100,2773,35,2010/2011,2011-04-30 00:00:00,Blackburn Rovers,Bolton Wanderers,1,0,1.91,3.5,4.0,9,1,10,11,5,10,2,1,0,0,30,24,3,10,43.0,57.0,1,10,21,15,3,0,54,13
1101,2775,35,2010/2011,2011-04-30 00:00:00,West Bromwich Albion,Aston Villa,2,1,2.38,3.3,3.0,2,5,3,6,8,9,3,1,0,0,6,16,2,7,36.0,64.0,3,7,9,17,4,0,22,9
1102,2776,35,2010/2011,2011-04-30 00:00:00,Blackpool,Stoke City,0,0,2.63,3.4,2.63,4,4,6,4,10,10,0,0,0,0,12,24,4,8,56.0,44.0,0,8,10,20,0,0,36,12
1103,2777,35,2010/2011,2011-04-30 00:00:00,Wigan Athletic,Everton,1,1,2.8,3.25,2.6,10,4,3,1,13,11,2,2,0,0,13,22,3,8,45.0,55.0,2,14,4,24,4,0,35,11
1104,2778,35,2010/2011,2011-04-30 00:00:00,Chelsea,Tottenham Hotspur,2,1,1.44,4.33,7.5,11,6,6,5,11,14,3,1,0,0,17,8,6,5,47.0,53.0,3,17,11,25,4,0,25,11
1105,2769,35,2010/2011,2011-05-01 00:00:00,Arsenal,Manchester United,1,0,2.5,3.25,2.88,2,7,7,4,12,7,2,3,0,0,22,19,3,6,46.0,54.0,1,9,11,19,5,0,41,9
1106,2770,35,2010/2011,2011-05-01 00:00:00,Liverpool,Newcastle United,3,0,1.44,4.33,7.5,8,4,4,4,15,10,1,2,0,0,12,22,3,12,45.0,55.0,3,12,8,25,3,0,34,15
1107,2772,35,2010/2011,2011-05-01 00:00:00,Manchester City,West Ham United,2,1,1.4,4.5,9.0,12,3,8,5,12,7,3,1,0,0,26,12,9,5,59.0,41.0,3,15,13,19,4,0,38,14
1108,2774,35,2010/2011,2011-05-01 00:00:00,Birmingham City,Wolverhampton Wanderers,1,1,2.1,3.3,3.6,1,4,6,3,9,14,3,3,0,0,6,21,0,2,48.0,52.0,2,5,9,23,6,0,27,2
1109,2780,36,2010/2011,2011-05-07 00:00:00,Tottenham Hotspur,Blackpool,1,1,1.3,5.5,10.0,12,6,10,6,8,12,3,2,0,0,37,11,7,4,54.0,46.0,2,18,16,20,5,0,48,11
1110,2781,36,2010/2011,2011-05-07 00:00:00,West Ham United,Blackburn Rovers,1,1,1.95,3.6,3.8,9,4,7,3,9,8,3,0,0,0,28,10,7,3,58.0,42.0,2,13,10,17,3,0,38,10
1111,2782,36,2010/2011,2011-05-07 00:00:00,Aston Villa,Wigan Athletic,1,1,1.8,3.6,4.5,5,2,2,4,5,10,2,0,0,0,13,5,2,5,49.0,51.0,2,7,6,15,2,0,18,7
1112,2783,36,2010/2011,2011-05-07 00:00:00,Everton,Manchester City,2,1,2.7,3.2,2.7,4,3,4,7,14,13,4,2,0,0,9,14,10,5,59.0,41.0,3,7,11,27,6,0,23,15
1113,2784,36,2010/2011,2011-05-07 00:00:00,Newcastle United,Birmingham City,2,1,1.91,3.4,4.2,12,1,6,3,11,12,1,4,0,1,26,7,8,2,65.0,35.0,3,13,9,23,5,1,33,10
1114,2787,36,2010/2011,2011-05-07 00:00:00,Bolton Wanderers,Sunderland,1,2,1.83,3.5,4.5,7,4,12,4,15,12,1,0,0,0,33,13,6,5,52.0,48.0,3,11,16,27,1,0,46,11
1115,2779,36,2010/2011,2011-05-08 00:00:00,Manchester United,Chelsea,2,1,2.38,3.25,3.1,6,8,7,8,13,16,2,4,0,0,16,17,7,2,44.0,56.0,3,14,15,29,6,0,33,9
1116,2785,36,2010/2011,2011-05-08 00:00:00,Wolverhampton Wanderers,West Bromwich Albion,3,1,2.1,3.4,3.5,7,6,4,8,10,9,3,1,0,0,21,10,8,3,53.0,47.0,4,13,12,19,4,0,31,11
1117,2788,36,2010/2011,2011-05-08 00:00:00,Stoke City,Arsenal,3,1,5.5,3.75,1.67,5,6,6,9,7,11,1,2,0,0,11,19,2,5,51.0,49.0,4,11,15,18,3,0,30,7
1118,2786,36,2010/2011,2011-05-09 00:00:00,Fulham,Liverpool,2,5,2.88,3.25,2.5,6,6,3,4,14,9,5,2,0,0,18,13,6,5,47.0,53.0,7,12,7,23,7,0,31,11
1119,2754,33,2010/2011,2011-05-10 00:00:00,Manchester City,Tottenham Hotspur,1,0,1.91,3.4,4.2,5,7,4,10,8,9,1,1,0,0,13,28,2,8,41.0,59.0,1,12,14,17,2,0,41,10
1120,2791,37,2010/2011,2011-05-14 00:00:00,Sunderland,Wolverhampton Wanderers,1,3,2.5,3.25,2.88,6,4,5,5,7,16,0,0,0,0,21,14,5,5,57.0,43.0,4,10,10,23,0,0,35,10
1121,2793,37,2010/2011,2011-05-14 00:00:00,Blackburn Rovers,Manchester United,1,1,5.0,3.6,1.73,1,3,3,5,9,10,3,0,0,0,3,13,2,6,36.0,64.0,2,4,8,19,3,0,16,8
1122,2795,37,2010/2011,2011-05-14 00:00:00,West Bromwich Albion,Everton,1,0,2.63,3.25,2.75,6,12,6,11,15,8,2,2,0,1,11,33,2,11,49.0,51.0,1,18,17,23,4,1,44,13
1123,2796,37,2010/2011,2011-05-14 00:00:00,Blackpool,Bolton Wanderers,4,3,2.2,3.4,3.25,2,6,5,8,14,13,2,4,0,0,17,21,5,5,49.0,51.0,7,8,13,27,6,0,38,10
1124,2789,37,2010/2011,2011-05-15 00:00:00,Arsenal,Aston Villa,1,2,1.36,5.0,8.5,9,3,14,3,8,10,1,4,0,0,33,6,13,2,64.0,36.0,3,12,17,18,5,0,39,15
1125,2790,37,2010/2011,2011-05-15 00:00:00,Liverpool,Tottenham Hotspur,0,2,1.73,3.8,4.75,5,5,9,4,13,7,2,1,0,0,34,14,11,5,48.0,52.0,2,10,13,20,3,0,48,16
1126,2794,37,2010/2011,2011-05-15 00:00:00,Birmingham City,Fulham,0,2,2.2,3.25,3.4,2,13,8,8,7,16,0,5,0,0,17,15,5,5,59.0,41.0,2,15,16,23,5,0,32,10
1127,2797,37,2010/2011,2011-05-15 00:00:00,Wigan Athletic,West Ham United,3,2,2.1,3.4,3.5,16,8,11,4,6,9,1,1,0,0,56,33,10,5,50.0,50.0,5,24,15,15,2,0,89,15
1128,2798,37,2010/2011,2011-05-15 00:00:00,Chelsea,Newcastle United,2,2,1.25,6.0,11.0,5,7,8,4,18,11,4,3,0,0,26,14,7,3,57.0,43.0,4,12,12,29,7,0,40,10
1129,2792,37,2010/2011,2011-05-17 00:00:00,Manchester City,Stoke City,3,0,1.36,4.75,9.0,7,3,7,3,7,9,0,3,0,0,12,17,4,3,52.0,48.0,3,10,10,16,3,0,29,7
1130,2799,38,2010/2011,2011-05-22 00:00:00,Manchester United,Blackpool,4,2,1.6,4.0,5.5,7,7,9,6,8,6,2,1,0,0,29,23,8,8,55.0,45.0,6,14,15,14,3,0,52,16
1131,2800,38,2010/2011,2011-05-22 00:00:00,Tottenham Hotspur,Birmingham City,2,1,1.53,4.0,6.5,10,2,9,5,7,13,0,4,0,0,22,11,7,5,57.0,43.0,3,12,14,20,4,0,33,12
1132,2801,38,2010/2011,2011-05-22 00:00:00,West Ham United,Sunderland,0,3,2.0,3.5,3.75,11,9,6,7,7,8,0,2,0,0,16,13,4,6,41.0,59.0,3,20,13,15,2,0,29,10
1133,2802,38,2010/2011,2011-05-22 00:00:00,Aston Villa,Liverpool,1,0,3.2,3.4,2.25,7,6,3,5,13,10,2,2,0,0,9,14,4,5,47.0,53.0,1,13,8,23,4,0,23,9
1134,2803,38,2010/2011,2011-05-22 00:00:00,Everton,Chelsea,1,0,3.1,3.25,2.38,2,13,9,8,10,15,3,2,0,0,17,20,6,5,49.0,51.0,1,15,17,25,5,0,37,11
1135,2804,38,2010/2011,2011-05-22 00:00:00,Newcastle United,West Bromwich Albion,3,3,2.0,3.5,3.75,8,5,5,6,5,9,0,0,0,0,32,14,7,6,66.0,34.0,6,13,11,14,0,0,46,13
1136,2805,38,2010/2011,2011-05-22 00:00:00,Wolverhampton Wanderers,Blackburn Rovers,2,3,2.2,3.0,3.75,4,10,10,3,12,11,3,1,0,0,36,13,8,3,54.0,46.0,5,14,13,23,4,0,49,11
1137,2806,38,2010/2011,2011-05-22 00:00:00,Fulham,Arsenal,2,2,3.75,3.6,1.95,2,5,3,5,8,4,2,1,1,0,26,39,5,2,42.0,58.0,4,7,8,12,3,1,65,7
1138,2807,38,2010/2011,2011-05-22 00:00:00,Bolton Wanderers,Manchester City,0,2,5.0,3.75,1.7,9,8,9,8,11,10,1,1,1,0,18,13,6,5,41.0,59.0,2,17,17,21,2,1,31,11
1139,2808,38,2010/2011,2011-05-22 00:00:00,Stoke City,Wigan Athletic,0,1,2.75,3.6,2.4,6,4,5,4,6,8,1,4,0,0,23,5,5,3,46.0,54.0,1,10,9,14,5,0,28,8
1140,2869,1,2011/2012,2011-08-13 00:00:00,Blackburn Rovers,Wolverhampton Wanderers,1,2,2.2,3.2,3.5,2,2,10,9,10,11,4,2,0,0,28,23,12,6,48.0,52.0,3,4,19,21,6,0,51,18
1141,2870,1,2011/2012,2011-08-13 00:00:00,Fulham,Aston Villa,0,0,2.2,3.2,3.5,7,1,4,6,12,20,2,4,0,0,13,17,2,3,50.0,50.0,0,8,10,32,6,0,30,5
1142,2871,1,2011/2012,2011-08-13 00:00:00,Liverpool,Sunderland,1,1,1.57,3.6,7.0,2,5,10,10,17,11,4,4,0,0,21,16,6,2,51.0,49.0,2,7,20,28,8,0,37,8
1143,2873,1,2011/2012,2011-08-13 00:00:00,Newcastle United,Arsenal,0,0,3.75,3.25,2.1,2,4,4,6,10,10,3,5,0,1,18,18,2,5,45.0,55.0,0,6,10,20,8,1,36,7
1144,2874,1,2011/2012,2011-08-13 00:00:00,Queens Park Rangers,Bolton Wanderers,0,4,2.4,3.25,3.0,8,9,8,6,8,15,1,2,1,0,15,15,3,2,47.0,53.0,4,17,14,23,3,1,30,5
1145,2878,1,2011/2012,2011-08-13 00:00:00,Wigan Athletic,Norwich City,1,1,2.2,3.2,3.5,7,2,10,10,11,8,2,2,0,0,16,10,8,3,50.0,50.0,2,9,20,19,4,0,26,11
1146,2875,1,2011/2012,2011-08-14 00:00:00,Stoke City,Chelsea,0,0,5.5,3.5,1.7,3,10,3,5,13,12,2,2,0,0,22,20,4,6,41.0,59.0,0,13,8,25,4,0,42,10
1147,2877,1,2011/2012,2011-08-14 00:00:00,West Bromwich Albion,Manchester United,1,2,6.5,4.0,1.53,7,4,7,8,18,11,3,2,0,0,16,23,6,5,37.0,63.0,3,11,15,29,5,0,39,11
1148,2872,1,2011/2012,2011-08-15 00:00:00,Manchester City,Swansea City,4,0,1.29,5.0,13.0,13,3,12,6,10,2,0,0,0,0,15,10,7,4,53.0,47.0,4,16,18,12,0,0,25,11
1149,2979,2,2011/2012,2011-08-20 00:00:00,Arsenal,Liverpool,0,2,2.5,3.25,2.9,5,5,6,6,11,8,2,2,0,0,19,20,9,5,50.0,50.0,2,10,12,19,4,0,39,14
1150,2980,2,2011/2012,2011-08-20 00:00:00,Aston Villa,Blackburn Rovers,3,1,1.73,3.4,5.5,3,3,4,8,7,13,3,0,0,0,16,18,5,4,57.0,43.0,4,6,12,20,3,0,34,9
1151,2982,2,2011/2012,2011-08-20 00:00:00,Chelsea,West Bromwich Albion,2,1,1.3,5.5,10.0,12,3,8,1,11,7,2,4,0,0,14,7,7,4,67.0,33.0,3,15,9,18,6,0,21,11
1152,2983,2,2011/2012,2011-08-20 00:00:00,Everton,Queens Park Rangers,0,1,1.53,3.8,7.0,6,0,9,4,9,5,1,1,0,0,12,2,1,1,51.0,49.0,1,6,13,14,2,0,14,2
1153,2986,2,2011/2012,2011-08-20 00:00:00,Sunderland,Newcastle United,0,1,2.2,3.25,3.4,5,3,8,2,14,8,3,3,0,0,15,8,8,6,49.0,51.0,1,8,10,22,6,0,23,14
1154,2987,2,2011/2012,2011-08-20 00:00:00,Swansea City,Wigan Athletic,0,0,2.1,3.3,3.6,8,2,6,7,9,19,0,3,0,0,19,11,7,7,60.0,40.0,0,10,13,28,3,0,30,14
1155,2981,2,2011/2012,2011-08-21 00:00:00,Bolton Wanderers,Manchester City,2,3,4.75,3.5,1.8,3,7,2,10,19,15,2,0,0,0,20,21,7,8,47.0,53.0,5,10,12,34,2,0,41,15
1156,2985,2,2011/2012,2011-08-21 00:00:00,Norwich City,Stoke City,1,1,2.6,3.3,2.75,6,8,2,9,11,12,0,2,1,0,17,25,3,6,47.0,53.0,2,14,11,23,2,1,42,9
1157,2988,2,2011/2012,2011-08-21 00:00:00,Wolverhampton Wanderers,Fulham,2,0,2.38,3.25,3.1,5,4,12,7,5,12,2,2,0,0,19,23,7,8,50.0,50.0,2,9,19,17,4,0,42,15
1158,2984,2,2011/2012,2011-08-22 00:00:00,Manchester United,Tottenham Hotspur,3,0,1.67,3.75,5.5,17,11,8,8,14,9,1,2,0,0,28,9,11,3,60.0,40.0,3,28,16,23,3,0,37,14
1159,3089,3,2011/2012,2011-08-27 00:00:00,Aston Villa,Wolverhampton Wanderers,0,0,2.1,3.25,3.75,7,1,11,2,10,10,1,3,0,0,27,20,11,8,48.0,52.0,0,8,13,20,4,0,47,19
1160,3090,3,2011/2012,2011-08-27 00:00:00,Blackburn Rovers,Everton,0,1,3.3,3.25,2.25,10,5,7,5,13,11,5,2,0,0,37,34,5,4,50.0,50.0,1,15,12,24,7,0,71,9
1161,3091,3,2011/2012,2011-08-27 00:00:00,Chelsea,Norwich City,3,1,1.2,6.5,15.0,7,6,9,2,13,9,2,2,0,1,16,10,7,6,68.0,32.0,4,13,11,22,4,1,26,13
1162,3092,3,2011/2012,2011-08-27 00:00:00,Liverpool,Bolton Wanderers,3,1,1.4,4.5,8.5,9,4,11,4,2,7,0,2,0,0,43,24,11,6,60.0,40.0,4,13,15,9,2,0,67,17
1163,3095,3,2011/2012,2011-08-27 00:00:00,Swansea City,Sunderland,0,0,2.38,3.3,3.0,8,8,10,4,7,9,1,1,0,0,20,18,7,4,55.0,45.0,0,16,14,16,2,0,38,11
1164,3098,3,2011/2012,2011-08-27 00:00:00,Wigan Athletic,Queens Park Rangers,2,0,2.25,3.3,3.25,6,4,5,11,9,7,2,0,0,0,5,8,5,6,51.0,49.0,2,10,16,16,2,0,13,11
1165,3093,3,2011/2012,2011-08-28 00:00:00,Manchester United,Arsenal,8,2,1.5,4.33,6.5,7,8,9,6,6,9,2,3,0,0,14,13,3,5,59.0,41.0,10,15,15,15,5,0,27,8
1166,3094,3,2011/2012,2011-08-28 00:00:00,Newcastle United,Fulham,2,1,2.1,3.25,3.75,6,10,3,7,19,8,2,1,0,0,18,17,6,6,47.0,53.0,3,16,10,27,3,0,35,12
1167,3096,3,2011/2012,2011-08-28 00:00:00,Tottenham Hotspur,Manchester City,1,5,2.88,3.3,2.5,12,8,5,10,12,7,2,4,0,0,23,12,10,5,48.0,52.0,6,20,15,19,6,0,35,15
1168,3097,3,2011/2012,2011-08-28 00:00:00,West Bromwich Albion,Stoke City,0,1,2.1,3.25,3.75,7,0,9,4,12,11,0,0,0,0,22,11,5,1,57.0,43.0,1,7,13,23,0,0,33,6
1169,3189,4,2011/2012,2011-09-10 00:00:00,Arsenal,Swansea City,1,0,1.36,4.75,9.0,7,6,12,5,8,6,3,2,0,0,33,21,4,5,59.0,41.0,1,13,17,14,5,0,54,9
1170,3190,4,2011/2012,2011-09-10 00:00:00,Bolton Wanderers,Manchester United,0,5,9.0,4.5,1.4,8,6,10,4,16,2,2,0,0,0,25,18,5,7,43.0,57.0,5,14,14,18,2,0,43,12
1171,3191,4,2011/2012,2011-09-10 00:00:00,Everton,Aston Villa,2,2,2.0,3.4,3.8,8,2,8,4,11,9,1,1,0,0,22,6,8,0,57.0,43.0,4,10,12,20,2,0,28,8
1172,3193,4,2011/2012,2011-09-10 00:00:00,Manchester City,Wigan Athletic,3,0,1.17,7.0,17.0,6,7,14,4,5,8,0,0,0,0,15,13,8,3,58.0,42.0,3,13,18,13,0,0,28,11
1173,3196,4,2011/2012,2011-09-10 00:00:00,Stoke City,Liverpool,1,0,3.25,3.3,2.25,2,14,2,8,11,14,0,1,0,0,10,33,2,13,43.0,57.0,1,16,10,25,1,0,43,15
1174,3197,4,2011/2012,2011-09-10 00:00:00,Sunderland,Chelsea,1,2,5.0,3.75,1.7,3,3,6,12,6,2,1,1,0,0,8,6,4,6,40.0,60.0,3,6,18,8,2,0,14,10
1175,3198,4,2011/2012,2011-09-10 00:00:00,Wolverhampton Wanderers,Tottenham Hotspur,0,2,3.0,3.25,2.4,6,4,4,11,6,12,3,2,0,0,13,20,4,10,43.0,57.0,2,10,15,18,5,0,33,14
1176,3192,4,2011/2012,2011-09-11 00:00:00,Fulham,Blackburn Rovers,1,1,1.67,3.6,5.5,8,5,7,4,9,14,3,1,0,0,39,12,11,2,55.0,45.0,2,13,11,23,4,0,51,13
1177,3194,4,2011/2012,2011-09-11 00:00:00,Norwich City,West Bromwich Albion,0,1,2.5,3.25,2.88,5,5,10,6,13,12,1,2,0,0,35,11,1,3,48.0,52.0,1,10,16,25,3,0,46,4
1178,3195,4,2011/2012,2011-09-12 00:00:00,Queens Park Rangers,Newcastle United,0,0,2.4,3.25,3.0,6,4,7,3,11,16,1,3,0,0,15,18,6,4,52.0,48.0,0,10,10,27,4,0,33,10
1179,3199,5,2011/2012,2011-09-17 00:00:00,Aston Villa,Newcastle United,1,1,1.91,3.4,4.2,2,10,8,8,12,8,1,1,0,0,16,30,4,9,50.0,50.0,2,12,16,20,2,0,46,13
1180,3200,5,2011/2012,2011-09-17 00:00:00,Blackburn Rovers,Arsenal,4,3,4.2,3.4,1.91,3,8,4,14,12,11,2,1,0,0,14,55,2,13,43.0,57.0,7,11,18,23,3,0,69,15
1181,3201,5,2011/2012,2011-09-17 00:00:00,Bolton Wanderers,Norwich City,1,2,1.8,3.6,4.6,5,3,2,7,7,8,3,1,1,0,33,26,6,7,50.0,50.0,3,8,9,15,4,1,59,13
1182,3202,5,2011/2012,2011-09-17 00:00:00,Everton,Wigan Athletic,3,1,1.5,4.0,7.0,6,2,8,7,15,7,2,1,0,0,21,11,4,9,52.0,48.0,4,8,15,22,3,0,32,13
1183,3206,5,2011/2012,2011-09-17 00:00:00,Swansea City,West Bromwich Albion,3,0,2.63,3.2,2.75,3,13,2,5,5,10,1,2,0,0,8,19,2,8,54.0,46.0,3,16,7,15,3,0,27,10
1184,3208,5,2011/2012,2011-09-17 00:00:00,Wolverhampton Wanderers,Queens Park Rangers,0,3,1.91,3.4,4.2,3,9,7,5,14,10,2,3,0,0,20,16,4,8,41.0,59.0,3,12,12,24,5,0,36,12
1185,3203,5,2011/2012,2011-09-18 00:00:00,Fulham,Manchester City,2,2,6.5,3.8,1.57,8,9,3,8,8,10,1,1,0,0,29,40,5,9,46.0,54.0,4,17,11,18,2,0,69,14
1186,3204,5,2011/2012,2011-09-18 00:00:00,Manchester United,Chelsea,3,1,1.83,3.5,4.5,4,8,6,13,11,14,2,3,0,0,18,24,5,10,50.0,50.0,4,12,19,25,5,0,42,15
1187,3205,5,2011/2012,2011-09-18 00:00:00,Sunderland,Stoke City,4,0,2.4,3.2,3.1,4,8,1,2,15,12,1,2,0,0,18,25,6,5,63.0,37.0,4,12,3,27,3,0,43,11
1188,3207,5,2011/2012,2011-09-18 00:00:00,Tottenham Hotspur,Liverpool,4,0,2.63,3.4,2.63,10,1,9,5,14,10,1,4,0,0,21,5,4,1,60.0,40.0,4,11,14,24,5,0,26,5
1189,3209,6,2011/2012,2011-09-24 00:00:00,Arsenal,Bolton Wanderers,3,0,1.44,4.5,7.0,13,2,10,1,8,8,0,1,0,1,19,9,9,2,61.0,39.0,3,15,11,16,1,1,28,11
1190,3210,6,2011/2012,2011-09-24 00:00:00,Chelsea,Swansea City,4,1,1.2,6.5,15.0,5,2,8,4,12,9,3,3,1,0,13,17,1,6,49.0,51.0,5,7,12,21,6,1,30,7
1191,3211,6,2011/2012,2011-09-24 00:00:00,Liverpool,Wolverhampton Wanderers,2,1,1.36,4.5,10.0,7,10,7,6,13,9,3,4,0,0,24,21,7,2,52.0,48.0,3,17,13,22,7,0,45,9
1192,3212,6,2011/2012,2011-09-24 00:00:00,Manchester City,Everton,2,0,1.44,4.33,7.5,8,4,9,5,9,13,1,5,0,0,29,14,7,5,60.0,40.0,2,12,14,22,6,0,43,12
1193,3213,6,2011/2012,2011-09-24 00:00:00,Newcastle United,Blackburn Rovers,3,1,1.83,3.5,4.5,5,1,10,3,4,15,0,4,0,0,28,9,4,2,60.0,40.0,4,6,13,19,4,0,37,6
1194,3216,6,2011/2012,2011-09-24 00:00:00,Stoke City,Manchester United,1,1,6.5,4.0,1.53,8,7,4,6,10,4,1,0,0,0,31,17,8,8,42.0,58.0,2,15,10,14,1,0,48,16
1195,3217,6,2011/2012,2011-09-24 00:00:00,West Bromwich Albion,Fulham,0,0,2.3,3.25,3.25,4,6,3,10,7,15,0,3,0,0,11,11,1,1,43.0,57.0,0,10,13,22,3,0,22,2
1196,3218,6,2011/2012,2011-09-24 00:00:00,Wigan Athletic,Tottenham Hotspur,1,2,4.0,3.5,1.91,3,7,2,8,13,8,3,1,0,0,3,14,1,9,39.0,61.0,3,10,10,21,4,0,17,10
1197,3215,6,2011/2012,2011-09-25 00:00:00,Queens Park Rangers,Aston Villa,1,1,2.3,3.25,3.2,6,4,11,6,15,20,1,6,0,0,20,21,11,8,54.0,46.0,2,10,17,35,7,0,41,19
1198,3214,6,2011/2012,2011-09-26 00:00:00,Norwich City,Sunderland,2,1,2.5,3.4,2.8,7,5,3,6,3,7,2,1,0,0,15,18,7,4,50.0,50.0,3,12,9,10,3,0,33,11
1199,3219,7,2011/2012,2011-10-01 00:00:00,Aston Villa,Wigan Athletic,2,0,1.62,3.75,6.0,8,7,6,5,13,6,0,1,0,0,15,20,5,10,49.0,51.0,2,15,11,19,1,0,35,15
1200,3220,7,2011/2012,2011-10-01 00:00:00,Blackburn Rovers,Manchester City,0,4,6.5,3.75,1.57,3,6,2,11,9,13,1,1,0,0,13,18,4,5,38.0,62.0,4,9,13,22,2,0,31,9
1201,3222,7,2011/2012,2011-10-01 00:00:00,Everton,Liverpool,0,2,3.1,3.2,2.4,4,5,7,7,15,9,1,1,1,0,17,32,5,9,42.0,58.0,2,9,14,24,2,1,49,14
1202,3224,7,2011/2012,2011-10-01 00:00:00,Manchester United,Norwich City,2,0,1.17,7.0,17.0,7,5,12,8,10,6,1,0,0,0,33,11,10,3,59.0,41.0,2,12,20,16,1,0,44,13
1203,3225,7,2011/2012,2011-10-01 00:00:00,Sunderland,West Bromwich Albion,2,2,2.25,3.4,3.2,6,3,5,4,12,17,2,0,0,0,30,17,8,3,51.0,49.0,4,9,9,29,2,0,47,11
1204,3228,7,2011/2012,2011-10-01 00:00:00,Wolverhampton Wanderers,Newcastle United,1,2,2.5,3.25,2.88,14,4,13,7,6,12,1,2,0,0,19,9,10,5,50.0,50.0,3,18,20,18,3,0,28,15
1205,3221,7,2011/2012,2011-10-02 00:00:00,Bolton Wanderers,Chelsea,1,5,6.5,4.0,1.53,8,6,5,6,11,11,1,2,0,0,13,14,4,5,47.0,53.0,6,14,11,22,3,0,27,9
1206,3223,7,2011/2012,2011-10-02 00:00:00,Fulham,Queens Park Rangers,6,0,2.0,3.3,4.0,8,10,7,7,9,2,2,3,0,0,23,21,4,4,57.0,43.0,6,18,14,11,5,0,44,8
1207,3226,7,2011/2012,2011-10-02 00:00:00,Swansea City,Stoke City,2,0,2.63,3.25,2.75,5,7,5,4,16,18,3,5,0,0,9,27,6,6,55.0,45.0,2,12,9,34,8,0,36,12
1208,3227,7,2011/2012,2011-10-02 00:00:00,Tottenham Hotspur,Arsenal,2,1,2.1,3.4,3.5,9,7,8,6,12,9,2,1,0,0,23,24,9,6,49.0,51.0,3,16,14,21,3,0,47,15
1209,3230,8,2011/2012,2011-10-15 00:00:00,Chelsea,Everton,3,1,1.36,4.5,10.0,2,3,2,4,12,10,2,2,0,0,25,9,2,2,61.0,39.0,4,5,6,22,4,0,34,4
1210,3231,8,2011/2012,2011-10-15 00:00:00,Liverpool,Manchester United,1,1,3.0,3.3,2.4,8,2,7,8,13,12,1,3,0,0,28,13,8,3,57.0,43.0,2,10,15,25,4,0,41,11
1211,3232,8,2011/2012,2011-10-15 00:00:00,Manchester City,Aston Villa,4,1,1.33,5.0,10.0,5,5,6,4,10,6,1,1,0,0,9,7,5,1,57.0,43.0,5,10,10,16,2,0,16,6
1212,3234,8,2011/2012,2011-10-15 00:00:00,Norwich City,Swansea City,3,1,2.2,3.3,3.4,3,5,7,5,5,6,0,1,0,0,16,6,4,4,39.0,61.0,4,8,12,11,1,0,22,8
1213,3235,8,2011/2012,2011-10-15 00:00:00,Queens Park Rangers,Blackburn Rovers,1,1,1.83,3.5,4.5,4,10,9,1,12,17,3,2,0,0,21,16,5,7,53.0,47.0,2,14,10,29,5,0,37,12
1214,3236,8,2011/2012,2011-10-15 00:00:00,Stoke City,Fulham,2,0,2.2,3.2,3.5,6,4,10,3,13,16,4,4,0,0,29,13,5,2,42.0,58.0,2,10,13,29,8,0,42,7
1215,3238,8,2011/2012,2011-10-15 00:00:00,Wigan Athletic,Bolton Wanderers,1,3,2.3,3.3,3.2,9,10,7,3,15,16,4,4,0,0,20,20,4,4,46.0,54.0,4,19,10,31,8,0,40,8
1216,3229,8,2011/2012,2011-10-16 00:00:00,Arsenal,Sunderland,2,1,1.44,4.33,7.5,8,2,10,4,12,21,3,3,0,0,25,10,9,2,58.0,42.0,3,10,14,33,6,0,35,11
1217,3233,8,2011/2012,2011-10-16 00:00:00,Newcastle United,Tottenham Hotspur,2,2,3.0,3.3,2.4,7,5,4,3,12,18,1,2,0,0,19,10,5,2,53.0,47.0,4,12,7,30,3,0,29,7
1218,3237,8,2011/2012,2011-10-16 00:00:00,West Bromwich Albion,Wolverhampton Wanderers,2,0,2.0,3.3,4.0,10,13,5,5,14,11,0,1,0,0,5,29,2,11,42.0,58.0,2,23,10,25,1,0,34,13
1219,3240,9,2011/2012,2011-10-22 00:00:00,Aston Villa,West Bromwich Albion,1,2,2.0,3.3,4.0,2,5,3,5,11,7,2,3,1,0,12,23,3,8,47.0,53.0,3,7,8,18,5,1,35,11
1220,3242,9,2011/2012,2011-10-22 00:00:00,Bolton Wanderers,Sunderland,0,2,2.2,3.2,3.5,7,7,6,7,15,15,0,3,0,0,17,21,2,10,43.0,57.0,2,14,13,30,3,0,38,12
1221,3244,9,2011/2012,2011-10-22 00:00:00,Liverpool,Norwich City,1,1,1.29,5.5,11.0,10,10,11,2,5,8,0,1,0,0,38,15,10,3,57.0,43.0,2,20,13,13,1,0,53,13
1222,3246,9,2011/2012,2011-10-22 00:00:00,Newcastle United,Wigan Athletic,1,0,1.57,3.8,6.5,10,5,3,7,7,21,3,2,0,0,23,13,7,3,53.0,47.0,1,15,10,28,5,0,36,10
1223,3248,9,2011/2012,2011-10-22 00:00:00,Wolverhampton Wanderers,Swansea City,2,2,2.0,3.4,3.8,13,8,8,5,13,11,2,0,0,0,32,24,8,13,41.0,59.0,4,21,13,24,2,0,56,21
1224,3239,9,2011/2012,2011-10-23 00:00:00,Arsenal,Stoke City,3,1,1.53,4.0,6.5,1,2,4,4,10,13,0,2,0,0,18,9,10,1,60.0,40.0,4,3,8,23,2,0,27,11
1225,3241,9,2011/2012,2011-10-23 00:00:00,Blackburn Rovers,Tottenham Hotspur,1,2,4.0,3.5,1.91,7,5,8,2,16,7,4,1,0,0,28,19,8,4,63.0,37.0,3,12,10,23,5,0,47,12
1226,3243,9,2011/2012,2011-10-23 00:00:00,Fulham,Everton,1,3,2.25,3.25,3.3,6,4,8,4,11,6,3,1,0,0,11,7,5,1,51.0,49.0,4,10,12,17,4,0,18,6
1227,3245,9,2011/2012,2011-10-23 00:00:00,Manchester United,Manchester City,1,6,2.0,3.4,3.8,7,6,5,9,16,12,4,4,1,0,22,10,7,4,47.0,53.0,7,13,14,28,8,1,32,11
1228,3247,9,2011/2012,2011-10-23 00:00:00,Queens Park Rangers,Chelsea,1,0,9.5,5.0,1.33,4,5,5,10,17,18,2,7,0,2,8,18,0,6,49.0,51.0,1,9,15,35,9,2,26,6
1229,2879,10,2011/2012,2011-10-29 00:00:00,Chelsea,Arsenal,3,5,1.62,4.0,5.5,6,1,4,6,7,19,2,3,0,0,25,23,3,2,51.0,49.0,8,7,10,26,5,0,48,5
1230,2880,10,2011/2012,2011-10-29 00:00:00,Everton,Manchester United,0,1,4.5,3.6,1.8,11,5,7,1,15,8,3,0,0,0,25,8,4,1,49.0,51.0,1,16,8,23,3,0,33,5
1231,2881,10,2011/2012,2011-10-29 00:00:00,Manchester City,Wolverhampton Wanderers,3,1,1.17,7.0,19.0,5,4,9,8,17,7,2,1,1,0,13,8,5,4,52.0,48.0,4,9,17,24,3,1,21,9
1232,2882,10,2011/2012,2011-10-29 00:00:00,Norwich City,Blackburn Rovers,3,3,1.91,3.6,4.0,3,2,6,4,6,7,2,1,0,0,20,10,6,2,47.0,53.0,6,5,10,13,3,0,30,8
1233,2884,10,2011/2012,2011-10-29 00:00:00,Sunderland,Aston Villa,2,2,2.1,3.3,3.6,7,3,6,6,8,15,1,3,0,0,24,16,5,6,46.0,54.0,4,10,12,23,4,0,40,11
1234,2885,10,2011/2012,2011-10-29 00:00:00,Swansea City,Bolton Wanderers,3,1,2.1,3.3,3.6,8,3,11,4,8,12,3,4,0,0,17,10,10,2,62.0,38.0,4,11,15,20,7,0,27,12
1235,2887,10,2011/2012,2011-10-29 00:00:00,West Bromwich Albion,Liverpool,0,2,4.0,3.3,2.0,4,7,5,10,12,10,1,0,0,0,12,25,3,9,41.0,59.0,2,11,15,22,1,0,37,12
1236,2888,10,2011/2012,2011-10-29 00:00:00,Wigan Athletic,Fulham,0,2,2.88,3.25,2.5,9,2,10,2,16,14,2,5,0,0,23,7,9,0,58.0,42.0,2,11,12,30,7,0,30,9
1237,2886,10,2011/2012,2011-10-30 00:00:00,Tottenham Hotspur,Queens Park Rangers,3,1,1.36,4.75,9.0,9,5,9,7,14,15,0,0,0,0,15,18,4,8,57.0,43.0,4,14,16,29,0,0,33,12
1238,2883,10,2011/2012,2011-10-31 00:00:00,Stoke City,Newcastle United,1,3,2.1,3.2,3.8,4,0,5,3,7,14,0,1,0,0,32,12,8,2,52.0,48.0,4,4,8,21,1,0,44,10
1239,2889,11,2011/2012,2011-11-05 00:00:00,Arsenal,West Bromwich Albion,3,0,1.4,4.5,8.5,5,4,5,6,11,12,0,0,0,0,23,5,4,1,59.0,41.0,3,9,11,23,0,0,28,5
1240,2890,11,2011/2012,2011-11-05 00:00:00,Aston Villa,Norwich City,3,2,1.83,3.5,4.5,6,8,5,2,11,9,1,5,0,0,19,19,6,6,48.0,52.0,5,14,7,20,6,0,38,12
1241,2891,11,2011/2012,2011-11-05 00:00:00,Blackburn Rovers,Chelsea,0,1,7.5,4.33,1.44,9,6,4,5,14,10,4,2,0,0,17,22,5,8,40.0,60.0,1,15,9,24,6,0,39,13
1242,2894,11,2011/2012,2011-11-05 00:00:00,Liverpool,Swansea City,0,0,1.29,5.5,10.0,12,6,10,6,15,5,2,1,0,0,38,11,11,4,42.0,58.0,0,18,16,20,3,0,49,15
1243,2895,11,2011/2012,2011-11-05 00:00:00,Manchester United,Sunderland,1,0,1.25,5.5,13.0,10,2,6,7,7,12,0,2,0,0,22,13,6,2,61.0,39.0,1,12,13,19,2,0,35,8
1244,2896,11,2011/2012,2011-11-05 00:00:00,Newcastle United,Everton,2,1,2.25,3.25,3.3,6,5,4,9,15,16,2,3,0,0,21,17,5,3,49.0,51.0,3,11,13,31,5,0,38,8
1245,2897,11,2011/2012,2011-11-05 00:00:00,Queens Park Rangers,Manchester City,2,3,10.0,5.0,1.33,8,5,9,9,6,14,1,1,0,0,15,4,3,1,52.0,48.0,5,13,18,20,2,0,19,4
1246,2892,11,2011/2012,2011-11-06 00:00:00,Bolton Wanderers,Stoke City,5,0,2.4,3.3,3.0,7,6,4,4,9,13,0,1,0,0,21,25,12,4,56.0,44.0,5,13,8,22,1,0,46,16
1247,2893,11,2011/2012,2011-11-06 00:00:00,Fulham,Tottenham Hotspur,1,3,3.25,3.3,2.25,17,6,10,0,6,12,0,1,0,0,31,13,11,1,52.0,48.0,4,23,10,18,1,0,44,12
1248,2898,11,2011/2012,2011-11-06 00:00:00,Wolverhampton Wanderers,Wigan Athletic,3,1,1.91,3.3,4.33,9,8,1,6,9,14,2,1,0,0,15,19,5,6,46.0,54.0,4,17,7,23,3,0,34,11
1249,2900,12,2011/2012,2011-11-19 00:00:00,Everton,Wolverhampton Wanderers,2,1,1.57,3.75,6.5,8,1,4,2,12,14,1,3,0,0,35,3,9,1,58.0,42.0,3,9,6,26,4,0,38,10
1250,2901,12,2011/2012,2011-11-19 00:00:00,Manchester City,Newcastle United,3,1,1.3,5.5,10.0,7,3,3,3,11,9,0,0,0,0,14,12,4,5,66.0,34.0,4,10,6,20,0,0,26,9
1251,2902,12,2011/2012,2011-11-19 00:00:00,Norwich City,Arsenal,1,2,5.5,3.6,1.67,3,12,5,6,13,9,3,0,0,0,13,15,1,6,40.0,60.0,3,15,11,22,3,0,28,7
1252,2903,12,2011/2012,2011-11-19 00:00:00,Stoke City,Queens Park Rangers,2,3,1.83,3.5,4.5,6,3,10,1,20,13,4,2,0,0,35,13,9,5,43.0,57.0,5,9,11,33,6,0,48,14
1253,2904,12,2011/2012,2011-11-19 00:00:00,Sunderland,Fulham,0,0,2.3,3.25,3.2,7,7,7,6,7,12,1,1,0,0,31,17,6,7,54.0,46.0,0,14,13,19,2,0,48,13
1254,2905,12,2011/2012,2011-11-19 00:00:00,Swansea City,Manchester United,0,1,6.5,4.2,1.5,5,6,2,7,6,8,0,1,0,0,25,16,6,2,53.0,47.0,1,11,9,14,1,0,41,8
1255,2907,12,2011/2012,2011-11-19 00:00:00,West Bromwich Albion,Bolton Wanderers,2,1,2.0,3.4,3.8,6,6,6,4,12,10,1,0,0,0,27,14,7,5,55.0,45.0,3,12,10,22,1,0,41,12
1256,2908,12,2011/2012,2011-11-19 00:00:00,Wigan Athletic,Blackburn Rovers,3,3,2.5,3.25,2.88,7,0,10,4,13,12,2,3,0,0,18,4,7,3,61.0,39.0,6,7,14,25,5,0,22,10
1257,2899,12,2011/2012,2011-11-20 00:00:00,Chelsea,Liverpool,1,2,1.83,3.5,4.5,6,1,16,7,14,12,3,2,0,0,23,11,6,5,54.0,46.0,3,7,23,26,5,0,34,11
1258,2906,12,2011/2012,2011-11-21 00:00:00,Tottenham Hotspur,Aston Villa,2,0,1.57,4.0,6.0,5,3,14,4,4,5,0,2,0,0,34,17,11,3,57.0,43.0,2,8,18,9,2,0,51,14
1259,2909,13,2011/2012,2011-11-26 00:00:00,Arsenal,Fulham,1,1,1.44,4.2,8.0,13,7,9,4,10,9,1,3,0,0,28,13,13,4,58.0,42.0,2,20,13,19,4,0,41,17
1260,2910,13,2011/2012,2011-11-26 00:00:00,Bolton Wanderers,Everton,0,2,3.1,3.25,2.38,5,13,2,4,11,12,1,1,1,0,16,19,2,4,40.0,60.0,2,18,6,23,2,1,35,6
1261,2911,13,2011/2012,2011-11-26 00:00:00,Chelsea,Wolverhampton Wanderers,3,0,1.22,6.0,15.0,12,3,7,6,9,10,1,2,0,0,22,10,9,2,53.0,47.0,3,15,13,19,3,0,32,11
1262,2913,13,2011/2012,2011-11-26 00:00:00,Manchester United,Newcastle United,1,1,1.4,4.5,8.5,15,5,12,4,12,15,1,4,0,0,29,12,11,3,70.0,30.0,2,20,16,27,5,0,41,14
1263,2914,13,2011/2012,2011-11-26 00:00:00,Norwich City,Queens Park Rangers,2,1,2.1,3.4,3.5,8,5,9,11,18,8,1,0,0,0,16,14,6,4,49.0,51.0,3,13,20,26,1,0,30,10
1264,2915,13,2011/2012,2011-11-26 00:00:00,Stoke City,Blackburn Rovers,3,1,1.83,3.5,4.5,2,8,4,9,12,7,0,0,0,0,24,12,2,6,56.0,44.0,4,10,13,19,0,0,36,8
1265,2916,13,2011/2012,2011-11-26 00:00:00,Sunderland,Wigan Athletic,1,2,1.67,3.6,5.5,9,1,5,2,8,8,3,1,0,0,16,9,3,2,49.0,51.0,3,10,7,16,4,0,25,5
1266,2918,13,2011/2012,2011-11-26 00:00:00,West Bromwich Albion,Tottenham Hotspur,1,3,4.0,3.6,1.91,5,12,4,8,12,12,2,1,0,0,19,20,1,11,42.0,58.0,4,17,12,24,3,0,39,12
1267,2912,13,2011/2012,2011-11-27 00:00:00,Liverpool,Manchester City,1,1,2.75,3.2,2.63,9,2,13,4,12,16,1,4,0,0,35,14,8,5,56.0,44.0,2,11,17,28,5,0,49,13
1268,2917,13,2011/2012,2011-11-27 00:00:00,Swansea City,Aston Villa,0,0,2.2,3.25,3.4,3,4,3,8,9,18,3,4,0,0,16,24,4,6,55.0,45.0,0,7,11,27,7,0,40,10
1269,2919,14,2011/2012,2011-12-03 00:00:00,Aston Villa,Manchester United,0,1,5.0,3.6,1.73,4,7,6,6,3,12,0,0,0,0,15,16,5,5,43.0,57.0,1,11,12,15,0,0,31,10
1270,2920,14,2011/2012,2011-12-03 00:00:00,Blackburn Rovers,Swansea City,4,2,2.1,3.4,3.5,6,3,6,5,10,11,1,1,0,0,11,17,3,4,48.0,52.0,6,9,11,21,2,0,28,7
1271,2923,14,2011/2012,2011-12-03 00:00:00,Manchester City,Norwich City,5,1,1.17,7.0,17.0,4,2,14,3,8,8,0,1,0,0,17,16,12,4,69.0,31.0,6,6,17,16,1,0,33,16
1272,2924,14,2011/2012,2011-12-03 00:00:00,Newcastle United,Chelsea,0,3,3.5,3.4,2.1,10,10,8,8,8,4,2,3,0,0,27,11,6,5,51.0,49.0,3,20,16,12,5,0,38,11
1273,2925,14,2011/2012,2011-12-03 00:00:00,Queens Park Rangers,West Bromwich Albion,1,1,2.25,3.3,3.25,2,9,10,7,9,11,0,3,0,0,19,15,3,5,53.0,47.0,2,11,17,20,3,0,34,8
1274,2926,14,2011/2012,2011-12-03 00:00:00,Tottenham Hotspur,Bolton Wanderers,3,0,1.3,5.0,12.0,13,7,10,6,11,5,0,2,0,1,24,12,7,6,70.0,30.0,3,20,16,16,2,1,36,13
1275,2927,14,2011/2012,2011-12-03 00:00:00,Wigan Athletic,Arsenal,0,4,6.0,4.0,1.57,6,7,3,6,8,12,3,2,0,0,14,18,4,5,42.0,58.0,4,13,9,20,5,0,32,9
1276,2921,14,2011/2012,2011-12-04 00:00:00,Everton,Stoke City,0,1,1.67,3.6,5.5,5,3,7,2,13,14,0,1,0,0,35,15,10,6,57.0,43.0,1,8,9,27,1,0,50,16
1277,2928,14,2011/2012,2011-12-04 00:00:00,Wolverhampton Wanderers,Sunderland,2,1,2.4,3.3,3.0,10,12,6,6,8,7,2,3,0,0,36,27,8,3,48.0,52.0,3,22,12,15,5,0,63,11
1278,2922,14,2011/2012,2011-12-05 00:00:00,Fulham,Liverpool,1,0,3.5,3.4,2.1,12,7,6,12,13,10,3,1,0,1,10,30,2,10,42.0,58.0,1,19,18,23,4,1,40,12
1279,2929,15,2011/2012,2011-12-10 00:00:00,Arsenal,Everton,1,0,1.53,4.0,6.5,7,2,6,6,5,13,2,2,0,0,48,31,7,4,48.0,52.0,1,9,12,18,4,0,79,11
1280,2930,15,2011/2012,2011-12-10 00:00:00,Bolton Wanderers,Aston Villa,1,2,2.5,3.3,2.88,10,7,8,7,8,7,1,2,0,0,16,20,6,10,48.0,52.0,3,17,15,15,3,0,36,16
1281,2932,15,2011/2012,2011-12-10 00:00:00,Liverpool,Queens Park Rangers,1,0,1.33,5.0,10.0,12,1,9,4,11,6,2,0,0,0,27,9,17,5,57.0,43.0,1,13,13,17,2,0,36,22
1282,2933,15,2011/2012,2011-12-10 00:00:00,Manchester United,Wolverhampton Wanderers,4,1,1.22,6.0,15.0,11,6,7,3,9,8,1,0,0,0,22,26,8,3,58.0,42.0,5,17,10,17,1,0,48,11
1283,2934,15,2011/2012,2011-12-10 00:00:00,Norwich City,Newcastle United,4,2,2.4,3.4,2.88,7,5,2,3,8,7,3,2,0,1,27,14,7,2,53.0,47.0,6,12,5,15,5,1,41,9
1284,2937,15,2011/2012,2011-12-10 00:00:00,Swansea City,Fulham,2,0,2.63,3.25,2.75,4,7,10,5,7,9,1,1,0,0,18,13,6,5,57.0,43.0,2,11,15,16,2,0,31,11
1285,2938,15,2011/2012,2011-12-10 00:00:00,West Bromwich Albion,Wigan Athletic,1,2,1.67,3.8,5.25,5,5,10,3,13,8,1,1,0,0,38,6,13,2,46.0,54.0,3,10,13,21,2,0,44,15
1286,2935,15,2011/2012,2011-12-11 00:00:00,Stoke City,Tottenham Hotspur,2,1,3.75,3.5,2.0,3,14,8,7,7,9,2,2,0,0,24,23,7,11,43.0,57.0,3,17,15,16,4,0,47,18
1287,2936,15,2011/2012,2011-12-11 00:00:00,Sunderland,Blackburn Rovers,2,1,1.83,3.5,4.5,7,2,19,2,9,11,2,2,0,0,49,3,9,0,60.0,40.0,3,9,21,20,4,0,52,9
1288,2931,15,2011/2012,2011-12-12 00:00:00,Chelsea,Manchester City,2,1,2.4,3.3,3.0,8,2,6,5,11,20,4,2,0,0,16,5,4,1,57.0,43.0,3,10,11,31,6,0,21,5
1289,2940,16,2011/2012,2011-12-17 00:00:00,Blackburn Rovers,West Bromwich Albion,1,2,2.38,3.3,3.0,11,6,4,6,5,15,1,1,0,0,15,30,3,7,44.0,56.0,3,17,10,20,2,0,45,10
1290,2941,16,2011/2012,2011-12-17 00:00:00,Everton,Norwich City,1,1,1.62,3.75,6.0,17,0,11,6,9,12,1,1,0,0,39,12,13,0,55.0,45.0,2,17,17,21,2,0,51,13
1291,2942,16,2011/2012,2011-12-17 00:00:00,Fulham,Bolton Wanderers,2,0,1.62,3.75,6.0,10,7,8,9,8,14,1,3,0,0,15,15,8,4,50.0,50.0,2,17,17,22,4,0,30,12
1292,2944,16,2011/2012,2011-12-17 00:00:00,Newcastle United,Swansea City,0,0,1.8,3.6,4.5,6,0,11,4,9,9,1,1,0,0,25,5,9,1,57.0,43.0,0,6,15,18,2,0,30,10
1293,2947,16,2011/2012,2011-12-17 00:00:00,Wigan Athletic,Chelsea,1,1,9.0,4.75,1.36,7,4,7,6,8,5,0,0,0,0,12,18,7,5,42.0,58.0,2,11,13,13,0,0,30,12
1294,2948,16,2011/2012,2011-12-17 00:00:00,Wolverhampton Wanderers,Stoke City,1,2,2.5,3.25,2.88,5,3,5,3,13,16,2,3,0,0,23,29,7,5,54.0,46.0,3,8,8,29,5,0,52,12
1295,2939,16,2011/2012,2011-12-18 00:00:00,Aston Villa,Liverpool,0,2,4.2,3.4,1.91,9,8,7,7,5,15,1,2,0,0,13,18,4,10,43.0,57.0,2,17,14,20,3,0,31,14
1296,2943,16,2011/2012,2011-12-18 00:00:00,Manchester City,Arsenal,1,0,1.73,3.75,4.5,9,10,5,5,14,10,2,3,0,0,31,18,4,6,51.0,49.0,1,19,10,24,5,0,49,10
1297,2945,16,2011/2012,2011-12-18 00:00:00,Queens Park Rangers,Manchester United,0,2,7.5,4.33,1.44,4,13,8,8,5,10,1,2,0,0,24,16,5,10,49.0,51.0,2,17,16,15,3,0,40,15
1298,2946,16,2011/2012,2011-12-18 00:00:00,Tottenham Hotspur,Sunderland,1,0,1.36,4.75,9.0,7,5,11,3,9,8,1,2,0,0,21,9,6,0,61.0,39.0,1,12,14,17,3,0,30,6
1299,2952,17,2011/2012,2011-12-20 00:00:00,Wolverhampton Wanderers,Norwich City,2,2,2.0,3.5,3.75,7,12,12,4,5,14,2,2,0,0,23,21,4,6,48.0,52.0,4,19,16,19,4,0,44,10
1300,2954,17,2011/2012,2011-12-20 00:00:00,Blackburn Rovers,Bolton Wanderers,1,2,2.1,3.4,3.5,5,2,11,3,10,7,3,0,0,0,29,22,5,9,49.0,51.0,3,7,14,17,3,0,51,14
1301,2949,17,2011/2012,2011-12-21 00:00:00,Queens Park Rangers,Sunderland,2,3,2.5,3.3,2.88,9,7,5,7,10,12,2,2,0,0,20,20,8,11,45.0,55.0,5,16,12,22,4,0,40,19
1302,2951,17,2011/2012,2011-12-21 00:00:00,Wigan Athletic,Liverpool,0,0,7.0,4.0,1.5,14,13,5,7,16,12,1,2,0,0,20,29,8,14,41.0,59.0,0,27,12,28,3,0,49,22
1303,2953,17,2011/2012,2011-12-21 00:00:00,Aston Villa,Arsenal,1,2,5.0,3.6,1.73,3,5,7,2,11,8,2,3,0,0,12,14,7,15,57.0,43.0,3,8,9,19,5,0,26,22
1304,2955,17,2011/2012,2011-12-21 00:00:00,Everton,Swansea City,1,0,1.57,3.75,6.5,8,3,8,0,7,14,1,2,0,0,17,6,8,2,53.0,47.0,1,11,8,21,3,0,23,10
1305,2956,17,2011/2012,2011-12-21 00:00:00,Fulham,Manchester United,0,5,5.0,3.6,1.73,9,7,5,5,8,8,1,0,0,0,9,16,3,10,31.0,69.0,5,16,10,16,1,0,25,13
1306,2957,17,2011/2012,2011-12-21 00:00:00,Manchester City,Stoke City,3,0,1.22,6.0,15.0,14,1,4,1,7,7,2,1,0,0,8,10,5,2,64.0,36.0,3,15,5,14,3,0,18,7
1307,2958,17,2011/2012,2011-12-21 00:00:00,Newcastle United,West Bromwich Albion,2,3,2.0,3.5,3.75,9,4,13,7,9,10,1,0,0,0,23,8,10,2,54.0,46.0,5,13,20,19,1,0,31,12
1308,2950,17,2011/2012,2011-12-22 00:00:00,Tottenham Hotspur,Chelsea,1,1,2.6,3.4,2.7,9,8,6,11,16,7,2,2,0,0,17,11,7,4,56.0,44.0,2,17,17,23,4,0,28,11
1309,2960,18,2011/2012,2011-12-26 00:00:00,Bolton Wanderers,Newcastle United,0,2,2.5,3.4,2.8,3,5,1,5,10,13,1,1,0,0,8,11,4,4,47.0,53.0,2,8,6,23,2,0,19,8
1310,2961,18,2011/2012,2011-12-26 00:00:00,Chelsea,Fulham,1,1,1.3,5.0,12.0,16,5,10,3,9,11,1,1,0,0,33,6,9,3,58.0,42.0,2,21,13,20,2,0,39,12
1311,2962,18,2011/2012,2011-12-26 00:00:00,Liverpool,Blackburn Rovers,1,1,1.25,5.5,13.0,11,2,16,4,8,16,1,0,0,0,31,5,9,2,65.0,35.0,2,13,20,24,1,0,36,11
1312,2963,18,2011/2012,2011-12-26 00:00:00,Manchester United,Wigan Athletic,5,0,1.14,7.5,21.0,4,5,10,4,10,10,2,1,0,1,26,7,10,2,61.0,39.0,5,9,14,20,3,1,33,12
1313,2965,18,2011/2012,2011-12-26 00:00:00,Stoke City,Aston Villa,0,0,1.91,3.4,4.2,3,3,4,6,11,10,3,0,0,0,29,19,7,7,49.0,51.0,0,6,10,21,3,0,48,14
1314,2966,18,2011/2012,2011-12-26 00:00:00,Sunderland,Everton,1,1,2.4,3.25,3.0,8,2,3,8,8,17,0,1,0,0,24,22,5,6,57.0,43.0,2,10,11,25,1,0,46,11
1315,2968,18,2011/2012,2011-12-26 00:00:00,West Bromwich Albion,Manchester City,0,0,7.0,4.5,1.44,2,8,5,9,7,9,0,1,0,0,12,21,5,9,43.0,57.0,0,10,14,16,1,0,33,14
1316,2959,18,2011/2012,2011-12-27 00:00:00,Arsenal,Wolverhampton Wanderers,1,1,1.22,6.0,15.0,14,3,10,2,5,12,2,3,0,1,21,4,13,3,73.0,27.0,2,17,12,17,5,1,25,16
1317,2964,18,2011/2012,2011-12-27 00:00:00,Norwich City,Tottenham Hotspur,0,2,4.5,3.6,1.8,3,8,7,11,7,7,1,1,0,0,14,25,3,10,36.0,64.0,2,11,18,14,2,0,39,13
1318,2967,18,2011/2012,2011-12-27 00:00:00,Swansea City,Queens Park Rangers,1,1,2.0,3.4,3.8,3,5,4,6,9,12,1,3,0,0,11,22,5,11,56.0,44.0,2,8,10,21,4,0,33,16
1319,2972,19,2011/2012,2011-12-30 00:00:00,Liverpool,Newcastle United,3,1,1.53,4.0,6.5,5,1,9,3,5,10,0,2,0,0,20,1,7,0,55.0,45.0,4,6,12,15,2,0,21,7
1320,2969,19,2011/2012,2011-12-31 00:00:00,Arsenal,Queens Park Rangers,1,0,1.25,5.5,13.0,10,5,8,3,11,13,2,2,0,0,12,7,12,4,62.0,38.0,1,15,11,24,4,0,19,16
1321,2970,19,2011/2012,2011-12-31 00:00:00,Bolton Wanderers,Wolverhampton Wanderers,1,1,2.2,3.25,3.4,8,4,4,4,12,9,0,0,0,0,18,17,3,6,52.0,48.0,2,12,8,21,0,0,35,9
1322,2971,19,2011/2012,2011-12-31 00:00:00,Chelsea,Aston Villa,1,3,1.29,5.0,13.0,4,6,13,3,6,12,1,1,0,0,28,8,9,2,62.0,38.0,4,10,16,18,2,0,36,11
1323,2973,19,2011/2012,2011-12-31 00:00:00,Manchester United,Blackburn Rovers,2,3,1.13,8.0,26.0,13,2,16,5,8,13,2,2,0,0,51,4,17,3,54.0,46.0,5,15,21,21,4,0,55,20
1324,2974,19,2011/2012,2011-12-31 00:00:00,Norwich City,Fulham,1,1,2.6,3.25,2.75,9,6,9,5,10,8,0,0,0,0,33,6,4,3,60.0,40.0,2,15,14,18,0,0,39,7
1325,2975,19,2011/2012,2011-12-31 00:00:00,Stoke City,Wigan Athletic,2,2,1.67,3.6,5.5,1,4,9,2,13,10,2,3,0,1,33,5,8,5,51.0,49.0,4,5,11,23,5,1,38,13
1326,2977,19,2011/2012,2011-12-31 00:00:00,Swansea City,Tottenham Hotspur,1,1,5.5,3.6,1.67,8,6,4,5,8,5,1,2,0,0,14,11,10,5,53.0,47.0,2,14,9,13,3,0,25,15
1327,2976,19,2011/2012,2012-01-01 00:00:00,Sunderland,Manchester City,1,0,6.5,4.0,1.53,4,13,4,13,8,7,1,1,0,0,5,23,1,10,41.0,59.0,1,17,17,15,2,0,28,11
1328,2978,19,2011/2012,2012-01-01 00:00:00,West Bromwich Albion,Everton,0,1,2.6,3.25,2.75,1,7,9,7,10,8,0,2,0,0,17,22,2,7,45.0,55.0,1,8,16,18,2,0,39,9
1329,2989,20,2011/2012,2012-01-02 00:00:00,Aston Villa,Swansea City,0,2,1.83,3.4,4.75,4,2,8,4,11,7,2,4,0,0,39,5,14,0,49.0,51.0,2,6,12,18,6,0,44,14
1330,2990,20,2011/2012,2012-01-02 00:00:00,Blackburn Rovers,Stoke City,1,2,2.5,3.25,2.88,7,1,7,5,7,6,2,1,0,0,31,22,8,3,55.0,45.0,3,8,12,13,3,0,53,11
1331,2992,20,2011/2012,2012-01-02 00:00:00,Fulham,Arsenal,2,1,4.0,3.5,1.91,7,10,13,6,7,12,0,1,0,0,25,18,4,3,51.0,49.0,3,17,19,19,1,0,43,7
1332,2995,20,2011/2012,2012-01-02 00:00:00,Queens Park Rangers,Norwich City,1,2,2.1,3.4,3.5,5,5,3,9,11,13,2,1,1,0,9,17,2,5,40.0,60.0,3,10,12,24,3,1,26,7
1333,2998,20,2011/2012,2012-01-02 00:00:00,Wolverhampton Wanderers,Chelsea,1,2,6.0,4.0,1.57,4,8,4,8,10,9,3,2,0,0,9,15,0,5,37.0,63.0,3,12,12,19,5,0,24,5
1334,2993,20,2011/2012,2012-01-03 00:00:00,Manchester City,Liverpool,3,0,1.91,3.4,4.2,5,8,3,7,12,9,1,2,0,0,4,16,5,6,49.0,51.0,3,13,10,21,3,0,20,11
1335,2996,20,2011/2012,2012-01-03 00:00:00,Tottenham Hotspur,West Bromwich Albion,1,0,1.33,5.0,10.0,9,2,10,7,4,16,0,5,0,0,32,11,13,7,68.0,32.0,1,11,17,20,5,0,43,20
1336,2997,20,2011/2012,2012-01-03 00:00:00,Wigan Athletic,Sunderland,1,4,2.63,3.25,2.75,8,3,9,1,6,8,1,0,0,0,15,7,9,5,56.0,44.0,5,11,10,14,1,0,22,14
1337,2991,20,2011/2012,2012-01-04 00:00:00,Everton,Bolton Wanderers,1,2,1.5,4.0,7.0,4,7,8,5,8,11,1,3,0,0,23,20,6,9,48.0,52.0,3,11,13,19,4,0,43,15
1338,2994,20,2011/2012,2012-01-04 00:00:00,Newcastle United,Manchester United,3,0,5.0,3.6,1.73,4,6,4,2,20,16,1,2,0,0,14,18,3,4,54.0,46.0,3,10,6,36,3,0,32,7
1339,2876,1,2011/2012,2012-01-11 00:00:00,Tottenham Hotspur,Everton,2,0,1.53,3.8,7.0,8,3,6,7,4,14,1,3,0,0,11,7,6,4,56.0,44.0,2,11,13,18,4,0,18,10
1340,2999,21,2011/2012,2012-01-14 00:00:00,Aston Villa,Everton,1,1,2.4,3.25,3.0,8,5,6,4,11,9,1,1,0,0,23,21,9,3,55.0,45.0,2,13,10,20,2,0,44,12
1341,3000,21,2011/2012,2012-01-14 00:00:00,Blackburn Rovers,Fulham,3,1,3.0,3.3,2.38,8,8,4,9,15,13,1,1,1,0,6,26,0,9,41.0,59.0,4,16,13,28,2,1,32,9
1342,3001,21,2011/2012,2012-01-14 00:00:00,Chelsea,Sunderland,1,0,1.4,4.5,8.5,9,3,15,6,6,7,3,1,0,0,19,12,8,2,61.0,39.0,1,12,21,13,4,0,31,10
1343,3002,21,2011/2012,2012-01-14 00:00:00,Liverpool,Stoke City,0,0,1.4,4.33,9.0,7,1,8,2,7,11,0,3,0,0,30,4,11,1,60.0,40.0,0,8,10,18,3,0,34,12
1344,3003,21,2011/2012,2012-01-14 00:00:00,Manchester United,Bolton Wanderers,3,0,1.14,8.0,17.0,8,6,12,6,8,7,0,1,0,0,22,9,11,3,61.0,39.0,3,14,18,15,1,0,31,14
1345,3006,21,2011/2012,2012-01-14 00:00:00,Tottenham Hotspur,Wolverhampton Wanderers,1,1,1.25,5.5,13.0,11,3,12,2,5,13,1,3,0,0,19,2,8,1,57.0,43.0,2,14,14,18,4,0,21,9
1346,3007,21,2011/2012,2012-01-14 00:00:00,West Bromwich Albion,Norwich City,1,2,2.0,3.4,3.8,10,6,7,3,6,14,0,1,0,0,26,10,10,5,52.0,48.0,3,16,10,20,1,0,36,15
1347,3004,21,2011/2012,2012-01-15 00:00:00,Newcastle United,Queens Park Rangers,1,0,1.73,3.6,5.0,2,6,4,7,5,11,0,4,0,0,13,7,3,1,56.0,44.0,1,8,11,16,4,0,20,4
1348,3005,21,2011/2012,2012-01-15 00:00:00,Swansea City,Arsenal,3,2,4.75,3.5,1.8,4,9,4,5,8,11,0,0,0,0,14,16,9,2,56.0,44.0,5,13,9,19,0,0,30,11
1349,3008,21,2011/2012,2012-01-16 00:00:00,Wigan Athletic,Manchester City,0,1,9.0,4.33,1.4,2,7,4,5,14,16,3,3,0,0,9,10,4,5,44.0,56.0,1,9,9,30,6,0,19,9
1350,3010,22,2011/2012,2012-01-21 00:00:00,Bolton Wanderers,Liverpool,3,1,6.0,3.75,1.62,6,7,5,3,9,15,0,2,0,0,14,23,5,5,52.0,48.0,4,13,8,24,2,0,37,10
1351,3011,22,2011/2012,2012-01-21 00:00:00,Everton,Blackburn Rovers,1,1,1.53,4.0,6.5,9,10,7,7,14,13,2,2,0,0,22,18,5,8,45.0,55.0,2,19,14,27,4,0,40,13
1352,3012,22,2011/2012,2012-01-21 00:00:00,Fulham,Newcastle United,5,2,2.0,3.4,3.8,3,6,4,6,8,12,0,4,0,0,4,15,2,5,50.0,50.0,7,9,10,20,4,0,19,7
1353,3014,22,2011/2012,2012-01-21 00:00:00,Norwich City,Chelsea,0,0,5.5,4.0,1.62,4,8,2,11,5,5,0,0,0,0,14,34,1,11,43.0,57.0,0,12,13,10,0,0,48,12
1354,3015,22,2011/2012,2012-01-21 00:00:00,Queens Park Rangers,Wigan Athletic,3,1,2.0,3.4,3.8,8,3,8,4,11,20,2,2,0,0,8,7,7,1,53.0,47.0,4,11,12,31,4,0,15,8
1355,3016,22,2011/2012,2012-01-21 00:00:00,Stoke City,West Bromwich Albion,1,2,1.91,3.4,4.2,4,3,6,11,10,11,0,0,0,0,30,10,5,1,53.0,47.0,3,7,17,21,0,0,40,6
1356,3017,22,2011/2012,2012-01-21 00:00:00,Sunderland,Swansea City,2,0,1.91,3.4,4.2,5,9,5,7,7,6,0,0,0,0,10,18,2,4,32.0,68.0,2,14,12,13,0,0,28,6
1357,3018,22,2011/2012,2012-01-21 00:00:00,Wolverhampton Wanderers,Aston Villa,2,3,2.5,3.25,2.88,7,3,4,6,10,10,1,0,1,0,26,21,13,3,48.0,52.0,5,10,10,20,1,1,47,16
1358,3009,22,2011/2012,2012-01-22 00:00:00,Arsenal,Manchester United,1,2,2.8,3.4,2.5,6,4,7,5,18,7,5,2,0,0,15,17,0,5,50.0,50.0,3,10,12,25,7,0,32,5
1359,3013,22,2011/2012,2012-01-22 00:00:00,Manchester City,Tottenham Hotspur,3,2,1.91,3.6,4.0,4,5,8,6,10,11,2,1,0,0,19,13,9,4,57.0,43.0,5,9,14,21,3,0,32,13
1360,3020,23,2011/2012,2012-01-31 00:00:00,Manchester United,Stoke City,2,0,1.33,5.0,10.0,10,4,4,5,9,16,1,3,0,0,17,12,9,2,71.0,29.0,2,14,9,25,4,0,29,11
1361,3022,23,2011/2012,2012-01-31 00:00:00,Swansea City,Chelsea,1,1,4.0,3.25,2.0,3,8,2,11,10,23,2,3,0,0,2,31,1,11,42.0,58.0,2,11,13,33,5,0,33,12
1362,3023,23,2011/2012,2012-01-31 00:00:00,Tottenham Hotspur,Wigan Athletic,3,1,1.22,6.0,15.0,9,4,9,4,6,7,0,1,0,0,22,15,5,0,54.0,46.0,4,13,13,13,1,0,37,5
1363,3024,23,2011/2012,2012-01-31 00:00:00,Wolverhampton Wanderers,Liverpool,0,3,5.0,3.8,1.7,2,13,4,7,6,8,1,3,0,0,14,22,5,4,43.0,57.0,3,15,11,14,4,0,36,9
1364,3027,23,2011/2012,2012-01-31 00:00:00,Everton,Manchester City,1,0,4.33,3.5,1.85,3,12,4,9,12,9,1,2,0,0,11,25,3,9,40.0,60.0,1,15,13,21,3,0,36,12
1365,3019,23,2011/2012,2012-02-01 00:00:00,Bolton Wanderers,Arsenal,0,0,5.0,3.75,1.7,6,5,6,11,8,12,1,1,0,0,21,18,6,6,43.0,57.0,0,11,17,20,2,0,39,12
1366,3021,23,2011/2012,2012-02-01 00:00:00,Sunderland,Norwich City,3,0,1.91,3.5,4.2,7,5,3,8,6,15,1,1,0,0,17,16,3,6,57.0,43.0,3,12,11,21,2,0,33,9
1367,3025,23,2011/2012,2012-02-01 00:00:00,Aston Villa,Queens Park Rangers,2,2,1.8,3.5,4.75,15,2,8,2,2,12,0,1,0,0,34,9,9,3,59.0,41.0,4,17,10,14,1,0,43,12
1368,3026,23,2011/2012,2012-02-01 00:00:00,Blackburn Rovers,Newcastle United,0,2,2.63,3.3,2.7,8,2,14,3,8,19,1,2,0,0,23,9,14,1,59.0,41.0,2,10,17,27,3,0,32,15
1369,3028,23,2011/2012,2012-02-01 00:00:00,Fulham,West Bromwich Albion,1,1,1.83,3.5,4.5,6,9,8,5,6,8,1,0,0,0,17,11,8,7,56.0,44.0,2,15,13,14,1,0,28,15
1370,3029,24,2011/2012,2012-02-04 00:00:00,Arsenal,Blackburn Rovers,7,1,1.29,5.5,11.0,2,3,10,0,9,15,2,3,0,1,19,4,11,1,57.0,43.0,8,5,10,24,5,1,23,12
1371,3032,24,2011/2012,2012-02-04 00:00:00,Manchester City,Fulham,3,0,1.3,5.5,10.0,7,6,7,4,10,7,1,3,0,0,7,9,4,6,51.0,49.0,3,13,11,17,4,0,16,10
1372,3034,24,2011/2012,2012-02-04 00:00:00,Norwich City,Bolton Wanderers,2,0,2.0,3.5,3.75,8,6,12,6,6,9,0,0,0,0,17,24,4,7,45.0,55.0,2,14,18,15,0,0,41,11
1373,3035,24,2011/2012,2012-02-04 00:00:00,Queens Park Rangers,Wolverhampton Wanderers,1,2,1.91,3.6,4.0,7,4,5,8,8,13,0,3,1,0,17,14,7,3,53.0,47.0,3,11,13,21,3,1,31,10
1374,3036,24,2011/2012,2012-02-04 00:00:00,Stoke City,Sunderland,0,1,2.25,3.25,3.3,4,2,5,2,12,7,0,1,1,0,22,14,5,5,56.0,44.0,1,6,7,19,1,1,36,10
1375,3037,24,2011/2012,2012-02-04 00:00:00,West Bromwich Albion,Swansea City,1,2,2.1,3.3,3.6,11,7,7,10,11,6,2,1,0,0,25,18,8,6,53.0,47.0,3,18,17,17,3,0,43,14
1376,3038,24,2011/2012,2012-02-04 00:00:00,Wigan Athletic,Everton,1,1,3.5,3.4,2.1,5,4,1,4,13,13,2,0,0,0,17,13,4,3,52.0,48.0,2,9,5,26,2,0,30,7
1377,3030,24,2011/2012,2012-02-05 00:00:00,Chelsea,Manchester United,3,3,2.5,3.3,2.88,6,9,11,4,15,16,2,1,0,0,15,20,6,6,50.0,50.0,6,15,15,31,3,0,35,12
1378,3033,24,2011/2012,2012-02-05 00:00:00,Newcastle United,Aston Villa,2,1,2.0,3.4,3.8,6,8,9,5,6,11,1,2,0,0,15,10,4,4,51.0,49.0,3,14,14,17,3,0,25,8
1379,3031,24,2011/2012,2012-02-06 00:00:00,Liverpool,Tottenham Hotspur,0,0,2.0,3.4,3.8,13,5,5,5,9,12,2,2,0,0,16,6,7,4,52.0,48.0,0,18,10,21,4,0,22,11
1380,3040,25,2011/2012,2012-02-11 00:00:00,Blackburn Rovers,Queens Park Rangers,3,2,2.38,3.3,3.0,3,13,3,10,9,11,1,1,0,0,8,22,5,6,44.0,56.0,5,16,13,20,2,0,30,11
1381,3041,25,2011/2012,2012-02-11 00:00:00,Bolton Wanderers,Wigan Athletic,1,2,2.0,3.5,3.75,4,4,7,4,19,11,3,2,0,0,12,9,7,7,45.0,55.0,3,8,11,30,5,0,21,14
1382,3042,25,2011/2012,2012-02-11 00:00:00,Everton,Chelsea,2,0,3.25,3.3,2.25,6,8,2,1,15,13,0,3,0,0,10,29,2,4,44.0,56.0,2,14,3,28,3,0,39,6
1383,3043,25,2011/2012,2012-02-11 00:00:00,Fulham,Stoke City,2,1,1.91,3.5,4.0,5,2,7,9,12,10,1,2,0,0,11,23,5,4,54.0,46.0,3,7,16,22,3,0,34,9
1384,3044,25,2011/2012,2012-02-11 00:00:00,Manchester United,Liverpool,2,1,1.85,3.6,4.33,4,4,5,4,10,12,1,1,0,0,9,12,4,3,51.0,49.0,3,8,9,22,2,0,21,7
1385,3045,25,2011/2012,2012-02-11 00:00:00,Sunderland,Arsenal,1,2,3.5,3.4,2.1,4,8,5,3,9,8,2,1,0,0,15,20,7,3,53.0,47.0,3,12,8,17,3,0,35,10
1386,3046,25,2011/2012,2012-02-11 00:00:00,Swansea City,Norwich City,2,3,1.83,3.5,4.5,7,6,7,8,6,12,0,2,0,0,21,16,6,8,55.0,45.0,5,13,15,18,2,0,37,14
1387,3047,25,2011/2012,2012-02-11 00:00:00,Tottenham Hotspur,Newcastle United,5,0,1.44,4.33,7.5,4,6,9,5,7,8,2,1,0,0,12,12,4,3,62.0,38.0,5,10,14,15,3,0,24,7
1388,3039,25,2011/2012,2012-02-12 00:00:00,Aston Villa,Manchester City,0,1,5.5,3.6,1.67,4,9,2,6,13,5,3,0,0,0,8,14,5,8,43.0,57.0,1,13,8,18,3,0,22,13
1389,3048,25,2011/2012,2012-02-12 00:00:00,Wolverhampton Wanderers,West Bromwich Albion,1,5,2.5,3.25,2.88,7,11,3,11,6,13,1,0,0,0,17,17,12,8,52.0,48.0,6,18,14,19,1,0,34,20
1390,3050,26,2011/2012,2012-02-25 00:00:00,Chelsea,Bolton Wanderers,3,0,1.29,5.5,11.0,10,1,10,6,6,8,0,1,0,0,23,8,13,7,63.0,37.0,3,11,16,14,1,0,31,20
1391,3052,26,2011/2012,2012-02-25 00:00:00,Manchester City,Blackburn Rovers,3,0,1.17,7.0,17.0,12,4,9,0,7,11,0,2,0,0,27,5,10,3,68.0,32.0,3,16,9,18,2,0,32,13
1392,3053,26,2011/2012,2012-02-25 00:00:00,Newcastle United,Wolverhampton Wanderers,2,2,1.57,4.0,6.0,7,7,5,1,9,8,1,1,0,0,13,8,3,3,51.0,49.0,4,14,6,17,2,0,21,6
1393,3055,26,2011/2012,2012-02-25 00:00:00,Queens Park Rangers,Fulham,0,1,2.63,3.25,2.75,8,2,8,4,18,15,1,4,0,0,17,10,6,5,45.0,55.0,1,10,12,33,5,0,27,11
1394,3057,26,2011/2012,2012-02-25 00:00:00,West Bromwich Albion,Sunderland,4,0,2.4,3.25,3.0,10,6,8,6,6,9,1,1,0,0,19,12,7,0,61.0,39.0,4,16,14,15,2,0,31,7
1395,3058,26,2011/2012,2012-02-25 00:00:00,Wigan Athletic,Aston Villa,0,0,2.75,3.25,2.63,5,4,9,7,9,9,0,4,0,0,16,8,13,7,50.0,50.0,0,9,16,18,4,0,24,20
1396,3049,26,2011/2012,2012-02-26 00:00:00,Arsenal,Tottenham Hotspur,5,2,2.5,3.4,2.75,8,4,11,7,12,10,3,3,0,0,23,18,7,5,56.0,44.0,7,12,18,22,6,0,41,12
1397,3054,26,2011/2012,2012-02-26 00:00:00,Norwich City,Manchester United,1,2,6.5,4.0,1.53,7,7,7,3,11,11,1,2,0,0,23,23,4,4,52.0,48.0,3,14,10,22,3,0,46,8
1398,3056,26,2011/2012,2012-02-26 00:00:00,Stoke City,Swansea City,2,0,2.1,3.4,3.5,4,4,5,6,12,5,1,0,0,0,20,11,8,4,59.0,41.0,2,8,11,17,1,0,31,12
1399,3059,27,2011/2012,2012-03-03 00:00:00,Blackburn Rovers,Aston Villa,1,1,2.38,3.4,3.0,7,11,7,6,7,1,1,0,0,0,26,21,3,9,60.0,40.0,2,18,13,8,1,0,47,12
1400,3061,27,2011/2012,2012-03-03 00:00:00,Liverpool,Arsenal,1,2,2.0,3.5,3.75,5,5,7,3,10,11,0,1,0,0,32,5,12,0,43.0,57.0,3,10,10,21,1,0,37,12
1401,3062,27,2011/2012,2012-03-03 00:00:00,Manchester City,Bolton Wanderers,2,0,1.13,8.5,21.0,13,6,10,2,12,6,0,0,0,0,10,7,8,4,64.0,36.0,2,19,12,18,0,0,17,12
1402,3064,27,2011/2012,2012-03-03 00:00:00,Queens Park Rangers,Everton,1,1,3.1,3.25,2.38,9,3,11,5,18,16,1,2,0,0,16,14,8,7,47.0,53.0,2,12,16,34,3,0,30,15
1403,3065,27,2011/2012,2012-03-03 00:00:00,Stoke City,Norwich City,1,0,1.83,3.5,4.5,7,6,5,2,11,17,0,2,0,0,33,9,8,2,51.0,49.0,1,13,7,28,2,0,42,10
1404,3067,27,2011/2012,2012-03-03 00:00:00,West Bromwich Albion,Chelsea,1,0,4.2,3.4,1.91,8,4,10,6,7,7,3,1,0,0,21,17,14,5,51.0,49.0,1,12,16,14,4,0,38,19
1405,3068,27,2011/2012,2012-03-03 00:00:00,Wigan Athletic,Swansea City,0,2,2.5,3.25,2.88,7,5,8,4,12,8,2,2,0,1,25,8,8,4,53.0,47.0,2,12,12,20,4,1,33,12
1406,3060,27,2011/2012,2012-03-04 00:00:00,Fulham,Wolverhampton Wanderers,5,0,1.57,3.75,6.5,13,5,6,7,5,7,1,2,0,0,20,18,7,7,55.0,45.0,5,18,13,12,3,0,38,14
1407,3063,27,2011/2012,2012-03-04 00:00:00,Newcastle United,Sunderland,1,1,2.1,3.4,3.5,12,6,14,2,10,10,5,3,0,2,40,9,19,4,56.0,44.0,2,18,16,20,8,2,49,23
1408,3066,27,2011/2012,2012-03-04 00:00:00,Tottenham Hotspur,Manchester United,1,3,2.88,3.4,2.4,7,2,9,1,10,12,1,2,0,0,25,10,7,3,58.0,42.0,4,9,10,22,3,0,35,10
1409,3070,28,2011/2012,2012-03-10 00:00:00,Aston Villa,Fulham,1,0,2.5,3.25,2.88,6,4,12,5,9,11,2,0,0,0,34,7,10,4,56.0,44.0,1,10,17,20,2,0,41,14
1410,3071,28,2011/2012,2012-03-10 00:00:00,Bolton Wanderers,Queens Park Rangers,2,1,2.5,3.25,2.88,6,8,4,7,9,10,2,2,0,0,25,22,9,6,48.0,52.0,3,14,11,19,4,0,47,15
1411,3072,28,2011/2012,2012-03-10 00:00:00,Chelsea,Stoke City,1,0,1.4,4.5,8.5,8,1,12,7,12,11,1,2,0,1,28,7,14,1,68.0,32.0,1,9,19,23,3,1,35,15
1412,3073,28,2011/2012,2012-03-10 00:00:00,Everton,Tottenham Hotspur,1,0,2.88,3.25,2.5,7,8,1,14,13,9,2,2,0,0,2,19,0,8,39.0,61.0,1,15,15,22,4,0,21,8
1413,3076,28,2011/2012,2012-03-10 00:00:00,Sunderland,Liverpool,1,0,3.8,3.4,2.0,1,6,5,4,7,9,1,1,0,0,10,13,3,2,42.0,58.0,1,7,9,16,2,0,23,5
1414,3078,28,2011/2012,2012-03-10 00:00:00,Wolverhampton Wanderers,Blackburn Rovers,0,2,2.38,3.3,3.0,7,7,7,6,10,10,1,2,0,0,20,15,3,4,51.0,49.0,2,14,13,20,3,0,35,7
1415,3074,28,2011/2012,2012-03-11 00:00:00,Manchester United,West Bromwich Albion,2,0,1.29,5.5,11.0,9,3,10,3,5,13,0,1,0,0,20,10,8,5,66.0,34.0,2,12,13,18,1,0,30,13
1416,3075,28,2011/2012,2012-03-11 00:00:00,Norwich City,Wigan Athletic,1,1,1.83,3.6,4.33,7,6,7,10,8,7,4,4,0,0,15,22,3,5,45.0,55.0,2,13,17,15,8,0,37,8
1417,3077,28,2011/2012,2012-03-11 00:00:00,Swansea City,Manchester City,1,0,6.0,3.75,1.62,4,11,5,7,5,12,0,2,0,0,19,17,8,8,50.0,50.0,1,15,12,17,2,0,36,16
1418,3069,28,2011/2012,2012-03-12 00:00:00,Arsenal,Newcastle United,2,1,1.44,4.33,7.5,9,3,11,2,11,11,2,3,0,0,26,5,6,3,59.0,41.0,3,12,13,22,5,0,31,9
1419,3051,26,2011/2012,2012-03-13 00:00:00,Liverpool,Everton,3,0,1.73,3.4,5.5,8,6,4,2,6,8,1,4,0,0,15,13,4,4,52.0,48.0,3,14,6,14,5,0,28,8
1420,3082,29,2011/2012,2012-03-17 00:00:00,Fulham,Swansea City,0,3,1.83,3.5,4.5,4,4,9,2,5,1,0,0,0,0,11,8,6,2,40.0,60.0,3,8,11,6,0,0,19,8
1421,3087,29,2011/2012,2012-03-17 00:00:00,Wigan Athletic,West Bromwich Albion,1,1,2.75,3.3,2.6,10,2,14,8,8,12,2,4,0,0,32,9,13,5,57.0,43.0,2,12,22,20,6,0,41,18
1422,3084,29,2011/2012,2012-03-18 00:00:00,Newcastle United,Norwich City,1,0,1.8,3.6,4.5,8,3,5,9,6,11,0,3,0,0,12,18,4,5,49.0,51.0,1,11,14,17,3,0,30,9
1423,3088,29,2011/2012,2012-03-18 00:00:00,Wolverhampton Wanderers,Manchester United,0,5,9.0,5.0,1.33,3,10,2,8,6,12,1,1,0,0,13,18,4,7,44.0,56.0,5,13,10,18,2,0,31,11
1424,3080,29,2011/2012,2012-03-20 00:00:00,Blackburn Rovers,Sunderland,2,0,2.4,3.4,2.88,4,1,8,3,13,11,0,1,0,0,18,23,7,7,49.0,51.0,2,5,11,24,1,0,41,14
1425,3081,29,2011/2012,2012-03-21 00:00:00,Everton,Arsenal,0,1,3.0,3.4,2.3,3,7,4,5,10,13,2,1,0,0,14,19,4,6,49.0,51.0,1,10,9,23,3,0,33,10
1426,3083,29,2011/2012,2012-03-21 00:00:00,Manchester City,Chelsea,2,1,1.91,3.6,4.0,4,1,13,5,9,9,1,2,0,0,23,13,11,4,52.0,48.0,3,5,18,18,3,0,36,15
1427,3085,29,2011/2012,2012-03-21 00:00:00,Queens Park Rangers,Liverpool,3,2,5.0,3.6,1.73,2,12,5,5,7,7,0,0,0,0,21,26,7,17,48.0,52.0,5,14,10,14,0,0,47,24
1428,3086,29,2011/2012,2012-03-21 00:00:00,Tottenham Hotspur,Stoke City,1,1,1.4,4.5,8.5,16,2,9,6,11,11,1,1,0,0,31,8,13,1,70.0,30.0,2,18,15,22,2,0,39,14
1429,3099,30,2011/2012,2012-03-24 00:00:00,Arsenal,Aston Villa,3,0,1.33,5.0,10.0,10,1,8,2,5,10,0,5,0,0,25,11,13,5,61.0,39.0,3,11,10,15,5,0,36,18
1430,3100,30,2011/2012,2012-03-24 00:00:00,Bolton Wanderers,Blackburn Rovers,2,1,2.4,3.4,2.9,3,2,8,6,7,4,0,2,0,0,30,21,11,5,54.0,46.0,3,5,14,11,2,0,51,16
1431,3101,30,2011/2012,2012-03-24 00:00:00,Chelsea,Tottenham Hotspur,0,0,1.83,3.6,4.33,2,5,6,10,7,14,1,2,0,0,23,11,6,5,45.0,55.0,0,7,16,21,3,0,34,11
1432,3102,30,2011/2012,2012-03-24 00:00:00,Liverpool,Wigan Athletic,1,2,1.29,5.5,11.0,4,2,7,3,16,8,1,2,0,0,13,3,6,0,57.0,43.0,3,6,10,24,3,0,16,6
1433,3104,30,2011/2012,2012-03-24 00:00:00,Norwich City,Wolverhampton Wanderers,2,1,1.73,3.75,4.75,9,4,3,4,12,9,2,2,0,0,9,14,5,5,64.0,36.0,3,13,7,21,4,0,23,10
1434,3105,30,2011/2012,2012-03-24 00:00:00,Stoke City,Manchester City,1,1,6.0,3.75,1.62,4,7,6,7,10,12,1,2,0,0,13,17,5,7,47.0,53.0,2,11,13,22,3,0,30,12
1435,3106,30,2011/2012,2012-03-24 00:00:00,Sunderland,Queens Park Rangers,3,1,2.0,3.4,3.8,5,5,8,5,11,11,2,3,0,1,14,11,5,2,57.0,43.0,4,10,13,22,5,1,25,7
1436,3107,30,2011/2012,2012-03-24 00:00:00,Swansea City,Everton,0,2,2.2,3.25,3.4,4,5,8,9,9,11,1,2,0,0,17,14,3,3,54.0,46.0,2,9,17,20,3,0,31,6
1437,3108,30,2011/2012,2012-03-25 00:00:00,West Bromwich Albion,Newcastle United,1,3,2.3,3.4,3.1,5,4,6,2,8,2,0,1,0,0,15,7,10,4,44.0,56.0,4,9,8,10,1,0,22,14
1438,3103,30,2011/2012,2012-03-26 00:00:00,Manchester United,Fulham,1,0,1.22,6.0,15.0,15,5,3,1,17,6,1,0,0,0,22,6,7,1,60.0,40.0,1,20,4,23,1,0,28,8
1439,3109,31,2011/2012,2012-03-31 00:00:00,Aston Villa,Chelsea,2,4,4.5,3.5,1.83,2,5,6,4,13,6,1,0,0,0,19,8,6,4,45.0,55.0,6,7,10,19,1,0,27,10
1440,3111,31,2011/2012,2012-03-31 00:00:00,Everton,West Bromwich Albion,2,0,1.83,3.5,4.5,7,4,6,4,8,12,2,1,0,0,14,8,5,2,53.0,47.0,2,11,10,20,3,0,22,7
1441,3112,31,2011/2012,2012-03-31 00:00:00,Fulham,Norwich City,2,1,1.7,3.75,5.0,8,6,4,6,10,10,1,2,0,0,8,20,6,6,53.0,47.0,3,14,10,20,3,0,28,12
1442,3113,31,2011/2012,2012-03-31 00:00:00,Manchester City,Sunderland,3,3,1.22,6.5,12.0,11,2,12,4,11,15,1,1,0,0,36,13,17,5,53.0,47.0,6,13,16,26,2,0,49,22
1443,3115,31,2011/2012,2012-03-31 00:00:00,Queens Park Rangers,Arsenal,2,1,5.5,4.2,1.57,6,7,2,6,14,10,5,2,0,0,8,13,4,6,53.0,47.0,3,13,8,24,7,0,21,10
1444,3117,31,2011/2012,2012-03-31 00:00:00,Wigan Athletic,Stoke City,2,0,2.63,3.25,2.75,10,0,2,4,12,14,2,4,0,0,20,10,8,1,59.0,41.0,2,10,6,26,6,0,30,9
1445,3118,31,2011/2012,2012-03-31 00:00:00,Wolverhampton Wanderers,Bolton Wanderers,2,3,2.3,3.4,3.1,12,9,8,8,11,12,1,1,0,0,30,14,13,4,51.0,49.0,5,21,16,23,2,0,44,17
1446,3114,31,2011/2012,2012-04-01 00:00:00,Newcastle United,Liverpool,2,0,2.88,3.4,2.4,2,6,5,3,9,10,3,3,0,1,13,18,3,6,48.0,52.0,2,8,8,19,6,1,31,9
1447,3116,31,2011/2012,2012-04-01 00:00:00,Tottenham Hotspur,Swansea City,3,1,1.4,4.5,8.5,7,5,9,4,7,9,0,0,0,0,26,15,7,7,42.0,58.0,4,12,13,16,0,0,41,14
1448,3110,31,2011/2012,2012-04-02 00:00:00,Blackburn Rovers,Manchester United,0,2,9.0,4.75,1.36,7,8,5,6,10,5,1,1,0,0,15,37,2,10,30.0,70.0,2,15,11,15,2,0,52,12
1449,3127,32,2011/2012,2012-04-06 00:00:00,Swansea City,Newcastle United,0,2,2.4,3.4,2.88,9,2,10,1,11,8,1,1,0,0,22,1,7,0,69.0,31.0,2,11,11,19,2,0,23,7
1450,3120,32,2011/2012,2012-04-07 00:00:00,Bolton Wanderers,Fulham,0,3,2.6,3.3,2.75,8,2,8,4,9,11,1,0,0,0,27,11,5,3,45.0,55.0,3,10,12,20,1,0,38,8
1451,3121,32,2011/2012,2012-04-07 00:00:00,Chelsea,Wigan Athletic,2,1,1.25,6.0,12.0,7,4,8,7,12,12,2,2,0,0,15,9,5,3,51.0,49.0,3,11,15,24,4,0,24,8
1452,3122,32,2011/2012,2012-04-07 00:00:00,Liverpool,Aston Villa,1,1,1.44,4.33,7.5,4,2,15,2,5,10,1,1,0,0,36,12,11,3,53.0,47.0,2,6,17,15,2,0,48,14
1453,3124,32,2011/2012,2012-04-07 00:00:00,Norwich City,Everton,2,2,3.0,3.3,2.4,9,6,4,3,7,16,0,3,0,0,17,15,2,4,49.0,51.0,4,15,7,23,3,0,32,6
1454,3125,32,2011/2012,2012-04-07 00:00:00,Stoke City,Wolverhampton Wanderers,2,1,1.57,4.0,6.0,5,10,7,3,8,11,1,1,0,0,18,16,3,8,51.0,49.0,3,15,10,19,2,0,34,11
1455,3126,32,2011/2012,2012-04-07 00:00:00,Sunderland,Tottenham Hotspur,0,0,3.3,3.4,2.2,5,8,6,5,13,12,2,2,0,0,22,18,11,4,42.0,58.0,0,13,11,25,4,0,40,15
1456,3128,32,2011/2012,2012-04-07 00:00:00,West Bromwich Albion,Blackburn Rovers,3,0,1.91,3.6,4.0,5,12,3,6,7,9,1,1,0,1,26,11,8,4,48.0,52.0,3,17,9,16,2,1,37,12
1457,3119,32,2011/2012,2012-04-08 00:00:00,Arsenal,Manchester City,1,0,2.4,3.4,2.88,3,3,8,4,16,15,2,4,0,0,30,13,7,6,60.0,40.0,1,6,12,31,6,0,43,13
1458,3123,32,2011/2012,2012-04-08 00:00:00,Manchester United,Queens Park Rangers,2,0,1.17,7.5,15.0,15,3,14,6,13,11,1,0,0,1,29,7,11,5,65.0,35.0,2,18,20,24,1,1,36,16
1459,3129,33,2011/2012,2012-04-09 00:00:00,Aston Villa,Stoke City,1,1,2.2,3.3,3.4,4,3,3,4,9,8,3,0,0,0,12,29,5,4,47.0,53.0,2,7,7,17,3,0,41,9
1460,3131,33,2011/2012,2012-04-09 00:00:00,Everton,Sunderland,4,0,1.83,3.5,4.5,10,1,10,4,7,12,0,2,0,0,15,10,5,2,60.0,40.0,4,11,14,19,2,0,25,7
1461,3132,33,2011/2012,2012-04-09 00:00:00,Fulham,Chelsea,1,1,3.5,3.4,2.1,7,3,0,11,4,10,1,3,0,0,13,18,7,11,44.0,56.0,2,10,11,14,4,0,31,18
1462,3134,33,2011/2012,2012-04-09 00:00:00,Newcastle United,Bolton Wanderers,2,0,1.53,4.2,6.0,3,5,3,4,6,17,1,1,0,0,20,22,6,5,52.0,48.0,2,8,7,23,2,0,42,11
1463,3136,33,2011/2012,2012-04-09 00:00:00,Tottenham Hotspur,Norwich City,1,2,1.29,5.5,11.0,9,5,7,6,14,11,1,2,0,0,24,10,10,3,53.0,47.0,3,14,13,25,3,0,34,13
1464,3130,33,2011/2012,2012-04-10 00:00:00,Blackburn Rovers,Liverpool,2,3,3.5,3.4,2.1,6,8,4,5,17,13,4,5,0,1,25,11,4,4,52.0,48.0,5,14,9,30,9,1,36,8
1465,3133,33,2011/2012,2012-04-11 00:00:00,Manchester City,West Bromwich Albion,4,0,1.25,5.5,13.0,10,2,5,3,7,10,0,0,0,0,13,6,6,2,64.0,36.0,4,12,8,17,0,0,19,8
1466,3135,33,2011/2012,2012-04-11 00:00:00,Queens Park Rangers,Swansea City,3,0,2.1,3.4,3.5,6,6,7,5,10,8,2,0,0,0,18,17,6,9,38.0,62.0,3,12,12,18,2,0,35,15
1467,3137,33,2011/2012,2012-04-11 00:00:00,Wigan Athletic,Manchester United,1,0,9.0,4.75,1.36,8,3,4,6,8,14,1,2,0,0,8,16,7,3,53.0,47.0,1,11,10,22,3,0,24,10
1468,3138,33,2011/2012,2012-04-11 00:00:00,Wolverhampton Wanderers,Arsenal,0,3,7.0,4.5,1.44,5,10,4,2,8,4,3,0,1,0,14,12,6,4,27.0,73.0,3,15,6,12,3,1,26,10
1469,3144,34,2011/2012,2012-04-14 00:00:00,Norwich City,Manchester City,1,6,6.0,4.2,1.53,9,9,6,6,9,4,1,2,0,0,18,9,3,5,46.0,54.0,7,18,12,13,3,0,27,8
1470,3146,34,2011/2012,2012-04-14 00:00:00,Sunderland,Wolverhampton Wanderers,0,0,1.5,4.2,6.5,6,9,9,4,4,12,0,1,0,0,21,18,8,4,55.0,45.0,0,15,13,16,1,0,39,12
1471,3147,34,2011/2012,2012-04-14 00:00:00,Swansea City,Blackburn Rovers,3,0,1.91,3.5,4.0,7,2,8,7,9,12,0,2,0,0,18,7,8,3,66.0,34.0,3,9,15,21,2,0,25,11
1472,3148,34,2011/2012,2012-04-14 00:00:00,West Bromwich Albion,Queens Park Rangers,1,0,2.1,3.4,3.5,9,8,6,10,13,11,3,1,0,0,12,18,6,7,49.0,51.0,1,17,16,24,4,0,30,13
1473,3143,34,2011/2012,2012-04-15 00:00:00,Manchester United,Aston Villa,4,0,1.22,6.5,13.0,11,2,10,7,8,8,3,3,0,0,17,6,11,4,64.0,36.0,4,13,17,16,6,0,23,15
1474,3139,34,2011/2012,2012-04-16 00:00:00,Arsenal,Wigan Athletic,1,2,1.25,6.0,12.0,10,5,9,5,16,15,2,3,0,0,30,8,9,3,64.0,36.0,3,15,14,31,5,0,38,12
1475,3149,35,2011/2012,2012-04-21 00:00:00,Arsenal,Chelsea,0,0,2.0,3.6,3.6,5,3,6,9,13,11,3,4,0,0,14,18,7,7,49.0,51.0,0,8,15,24,7,0,32,14
1476,3150,35,2011/2012,2012-04-21 00:00:00,Aston Villa,Sunderland,0,0,2.3,3.3,3.2,7,3,5,7,9,9,0,2,0,0,18,11,8,5,47.0,53.0,0,10,12,18,2,0,29,13
1477,3151,35,2011/2012,2012-04-21 00:00:00,Blackburn Rovers,Norwich City,2,0,2.1,3.4,3.5,6,4,4,6,9,13,1,1,0,0,22,26,9,7,42.0,58.0,2,10,10,22,2,0,48,16
1478,3152,35,2011/2012,2012-04-21 00:00:00,Bolton Wanderers,Swansea City,1,1,2.2,3.3,3.4,3,10,4,9,19,9,2,1,0,0,20,13,8,10,49.0,51.0,2,13,13,28,3,0,33,18
1479,3153,35,2011/2012,2012-04-21 00:00:00,Fulham,Wigan Athletic,2,1,1.91,3.6,4.0,6,3,8,4,12,15,1,2,0,0,15,8,4,0,53.0,47.0,3,9,12,27,3,0,23,4
1480,3156,35,2011/2012,2012-04-21 00:00:00,Newcastle United,Stoke City,3,0,1.67,3.75,5.5,7,2,6,6,5,10,0,2,0,0,9,14,4,5,60.0,40.0,3,9,12,15,2,0,23,9
1481,3157,35,2011/2012,2012-04-21 00:00:00,Queens Park Rangers,Tottenham Hotspur,1,0,4.0,3.6,1.91,4,11,7,7,13,10,4,0,0,0,7,19,4,13,44.0,56.0,1,15,14,23,4,0,26,17
1482,3154,35,2011/2012,2012-04-22 00:00:00,Liverpool,West Bromwich Albion,0,1,1.44,4.33,7.5,19,5,14,4,9,7,2,0,0,0,32,9,15,3,62.0,38.0,1,24,18,16,2,0,41,18
1483,3155,35,2011/2012,2012-04-22 00:00:00,Manchester United,Everton,4,4,1.3,5.0,11.0,8,6,10,7,8,13,1,2,0,0,32,11,5,2,54.0,46.0,8,14,17,21,3,0,43,7
1484,3158,35,2011/2012,2012-04-22 00:00:00,Wolverhampton Wanderers,Manchester City,0,2,12.0,6.5,1.22,3,7,3,8,5,10,0,1,0,0,19,17,7,4,54.0,46.0,2,10,11,15,1,0,36,11
1485,3079,29,2011/2012,2012-04-24 00:00:00,Aston Villa,Bolton Wanderers,1,2,1.91,3.5,4.0,5,8,12,2,6,10,1,2,0,0,19,12,8,5,48.0,52.0,3,13,14,16,3,0,31,13
1486,3160,36,2011/2012,2012-04-28 00:00:00,Everton,Fulham,4,0,1.83,3.5,4.5,7,4,2,1,7,10,1,1,0,0,13,10,3,5,68.0,32.0,4,11,3,17,2,0,23,8
1487,3162,36,2011/2012,2012-04-28 00:00:00,Norwich City,Liverpool,0,3,3.8,3.4,2.0,2,6,6,7,9,4,4,0,0,0,13,11,4,7,39.0,61.0,3,8,13,13,4,0,24,11
1488,3163,36,2011/2012,2012-04-28 00:00:00,Stoke City,Arsenal,1,1,4.33,3.6,1.83,1,9,3,7,7,12,1,2,0,0,18,12,2,5,43.0,57.0,2,10,10,19,3,0,30,7
1489,3164,36,2011/2012,2012-04-28 00:00:00,Sunderland,Bolton Wanderers,2,2,2.0,3.5,3.75,4,7,5,8,8,18,1,0,0,0,17,19,7,5,47.0,53.0,4,11,13,26,1,0,36,12
1490,3165,36,2011/2012,2012-04-28 00:00:00,Swansea City,Wolverhampton Wanderers,4,4,1.53,4.0,6.5,6,5,2,8,8,10,2,1,0,0,8,32,2,6,56.0,44.0,8,11,10,18,3,0,40,8
1491,3167,36,2011/2012,2012-04-28 00:00:00,West Bromwich Albion,Aston Villa,0,0,2.1,3.4,3.5,10,7,8,3,14,14,0,4,0,0,23,14,9,3,56.0,44.0,0,17,11,28,4,0,37,12
1492,3168,36,2011/2012,2012-04-28 00:00:00,Wigan Athletic,Newcastle United,4,0,2.8,3.4,2.5,5,3,3,8,15,12,2,1,0,0,11,14,4,1,52.0,48.0,4,8,11,27,3,0,25,5
1493,3159,36,2011/2012,2012-04-29 00:00:00,Chelsea,Queens Park Rangers,6,1,1.4,4.5,8.5,11,5,8,5,9,10,0,1,0,0,14,17,8,5,64.0,36.0,7,16,13,19,1,0,31,13
1494,3166,36,2011/2012,2012-04-29 00:00:00,Tottenham Hotspur,Blackburn Rovers,2,0,1.36,5.0,8.0,7,0,11,0,6,14,0,0,0,0,25,9,6,1,64.0,36.0,2,7,11,20,0,0,34,7
1495,3161,36,2011/2012,2012-04-30 00:00:00,Manchester City,Manchester United,1,0,2.1,3.5,3.4,4,4,10,3,12,15,3,2,0,0,22,19,8,8,52.0,48.0,1,8,13,27,5,0,41,16
1496,3142,34,2011/2012,2012-05-01 00:00:00,Liverpool,Fulham,0,1,1.62,4.0,5.5,5,5,14,4,13,8,0,0,0,0,17,5,5,4,58.0,42.0,1,10,18,21,0,0,22,9
1497,3145,34,2011/2012,2012-05-01 00:00:00,Stoke City,Everton,1,1,2.75,3.25,2.6,4,4,7,9,7,14,2,1,0,0,33,28,4,6,53.0,47.0,2,8,16,21,3,0,61,10
1498,3140,34,2011/2012,2012-05-02 00:00:00,Bolton Wanderers,Tottenham Hotspur,1,4,4.0,3.6,1.91,6,5,6,6,6,9,2,1,0,0,14,11,4,7,45.0,55.0,5,11,12,15,3,0,25,11
1499,3141,34,2011/2012,2012-05-02 00:00:00,Chelsea,Newcastle United,0,2,1.5,4.33,6.5,6,3,12,6,8,7,0,3,0,0,17,7,4,4,52.0,48.0,2,9,18,15,3,0,24,8
1500,3169,37,2011/2012,2012-05-05 00:00:00,Arsenal,Norwich City,3,3,1.22,6.5,12.0,9,2,8,6,7,15,2,3,0,0,22,16,6,1,60.0,40.0,6,11,14,22,5,0,38,7
1501,3170,37,2011/2012,2012-05-06 00:00:00,Aston Villa,Tottenham Hotspur,1,1,4.2,3.75,1.83,2,9,3,12,8,8,1,2,0,1,8,43,4,19,37.0,63.0,2,11,15,16,3,1,51,23
1502,3172,37,2011/2012,2012-05-06 00:00:00,Bolton Wanderers,West Bromwich Albion,2,2,2.0,3.5,3.75,6,10,5,6,15,10,1,4,0,0,16,15,4,4,40.0,60.0,4,16,11,25,5,0,31,8
1503,3173,37,2011/2012,2012-05-06 00:00:00,Fulham,Sunderland,2,1,1.83,3.6,4.33,8,5,5,5,6,6,0,0,0,0,12,8,9,2,52.0,48.0,3,13,10,12,0,0,20,11
1504,3175,37,2011/2012,2012-05-06 00:00:00,Manchester United,Swansea City,2,0,1.17,7.0,17.0,16,7,10,4,11,7,1,0,0,0,41,9,16,3,54.0,46.0,2,23,14,18,1,0,50,19
1505,3176,37,2011/2012,2012-05-06 00:00:00,Newcastle United,Manchester City,0,2,5.0,4.0,1.67,7,10,6,9,12,8,4,3,0,0,12,14,2,6,46.0,54.0,2,17,15,20,7,0,26,8
1506,3177,37,2011/2012,2012-05-06 00:00:00,Queens Park Rangers,Stoke City,1,0,1.83,3.75,4.2,11,1,8,8,11,16,0,0,0,0,25,19,7,3,53.0,47.0,1,12,16,27,0,0,44,10
1507,3178,37,2011/2012,2012-05-06 00:00:00,Wolverhampton Wanderers,Everton,0,0,5.0,3.75,1.7,1,9,7,7,6,9,0,0,0,0,8,19,3,6,46.0,54.0,0,10,14,15,0,0,27,9
1508,3171,37,2011/2012,2012-05-07 00:00:00,Blackburn Rovers,Wigan Athletic,0,1,2.4,3.5,2.88,4,7,7,9,12,12,2,1,0,0,9,21,5,6,36.0,64.0,1,11,16,24,3,0,30,11
1509,3174,37,2011/2012,2012-05-08 00:00:00,Liverpool,Chelsea,4,1,2.1,3.5,3.4,9,2,13,5,18,14,2,4,0,0,20,14,7,4,48.0,52.0,5,11,18,32,6,0,34,11
1510,3179,38,2011/2012,2012-05-13 00:00:00,Chelsea,Blackburn Rovers,2,1,1.3,5.5,10.0,5,5,13,1,10,1,1,0,0,0,22,3,8,2,56.0,44.0,3,10,14,11,1,0,25,10
1511,3180,38,2011/2012,2012-05-13 00:00:00,Everton,Newcastle United,3,1,2.2,3.5,3.2,6,8,7,6,17,14,2,1,1,0,7,8,4,3,48.0,52.0,4,14,13,31,3,1,15,7
1512,3181,38,2011/2012,2012-05-13 00:00:00,Manchester City,Queens Park Rangers,3,2,1.13,9.0,19.0,26,1,13,0,4,7,1,1,0,1,61,3,19,0,80.0,20.0,5,27,13,11,2,1,64,19
1513,3182,38,2011/2012,2012-05-13 00:00:00,Norwich City,Aston Villa,2,0,2.2,3.4,3.25,13,8,9,2,9,9,1,2,0,0,21,11,10,6,55.0,45.0,2,21,11,18,3,0,32,16
1514,3183,38,2011/2012,2012-05-13 00:00:00,Stoke City,Bolton Wanderers,2,2,2.38,3.5,2.88,7,7,4,10,7,5,1,1,0,0,17,20,6,8,33.0,67.0,4,14,14,12,2,0,37,14
1515,3184,38,2011/2012,2012-05-13 00:00:00,Sunderland,Manchester United,0,1,7.0,4.5,1.44,4,9,4,8,14,12,3,3,0,0,11,20,1,9,50.0,50.0,1,13,12,26,6,0,31,10
1516,3185,38,2011/2012,2012-05-13 00:00:00,Swansea City,Liverpool,1,0,3.4,3.5,2.1,8,8,5,5,6,5,1,1,0,0,11,12,6,6,63.0,37.0,1,16,10,11,2,0,23,12
1517,3186,38,2011/2012,2012-05-13 00:00:00,Tottenham Hotspur,Fulham,2,0,1.4,4.5,8.5,7,6,8,3,10,11,0,2,0,0,16,10,9,3,54.0,46.0,2,13,11,21,2,0,26,12
1518,3187,38,2011/2012,2012-05-13 00:00:00,West Bromwich Albion,Arsenal,2,3,5.0,4.0,1.67,7,6,2,5,11,9,0,1,0,0,25,24,9,5,40.0,60.0,5,13,7,20,1,0,49,14
1519,3188,38,2011/2012,2012-05-13 00:00:00,Wigan Athletic,Wolverhampton Wanderers,3,2,1.57,4.0,6.0,5,5,6,2,13,6,1,2,0,0,17,11,9,2,56.0,44.0,5,10,8,19,3,0,28,11
1520,3249,1,2012/2013,2012-08-18 00:00:00,Arsenal,Sunderland,0,0,1.4,4.5,8.5,11,3,12,1,12,8,0,0,0,0,27,3,7,0,52.0,48.0,0,14,13,20,0,0,30,7
1521,3251,1,2012/2013,2012-08-18 00:00:00,Fulham,Norwich City,5,0,1.8,3.6,4.5,8,4,3,5,11,11,0,0,0,0,23,21,6,3,56.0,44.0,5,12,8,22,0,0,44,9
1522,3253,1,2012/2013,2012-08-18 00:00:00,Newcastle United,Tottenham Hotspur,2,1,2.5,3.4,2.75,1,7,3,7,13,8,2,2,0,0,18,19,3,5,55.0,45.0,3,8,10,21,4,0,37,8
1523,3254,1,2012/2013,2012-08-18 00:00:00,Queens Park Rangers,Swansea City,0,5,2.0,3.4,3.8,10,4,10,6,12,13,2,2,0,0,20,7,5,3,49.0,51.0,5,14,16,25,4,0,27,8
1524,3255,1,2012/2013,2012-08-18 00:00:00,Reading,Stoke City,1,1,2.38,3.25,3.1,3,5,9,3,11,14,2,4,0,0,22,17,4,3,64.0,36.0,2,8,12,25,6,0,39,7
1525,3256,1,2012/2013,2012-08-18 00:00:00,West Bromwich Albion,Liverpool,3,0,4.2,3.5,1.91,3,7,9,8,11,12,1,4,0,1,11,18,7,3,38.0,62.0,3,10,17,23,5,1,29,10
1526,3257,1,2012/2013,2012-08-18 00:00:00,West Ham United,Aston Villa,1,0,2.2,3.3,3.4,4,5,5,7,12,11,0,1,0,0,17,11,6,4,48.0,52.0,1,9,12,23,1,0,28,10
1527,3252,1,2012/2013,2012-08-19 00:00:00,Manchester City,Southampton,3,2,1.17,7.0,17.0,10,4,7,5,4,7,1,2,0,0,22,13,7,3,69.0,31.0,5,14,12,11,3,0,35,10
1528,3258,1,2012/2013,2012-08-19 00:00:00,Wigan Athletic,Chelsea,0,2,6.0,3.75,1.62,4,2,10,2,17,12,2,2,0,0,43,6,7,1,53.0,47.0,2,6,12,29,4,0,49,8
1529,3250,1,2012/2013,2012-08-20 00:00:00,Everton,Manchester United,1,0,4.33,3.6,1.83,7,9,11,4,12,12,1,2,0,0,23,31,6,8,44.0,56.0,1,16,15,24,3,0,54,14
1530,3469,3,2012/2013,2012-08-22 00:00:00,Chelsea,Reading,4,2,1.25,5.5,13.0,9,3,13,2,13,13,0,2,0,0,19,17,1,5,60.0,40.0,6,12,15,26,2,0,36,6
1531,3359,2,2012/2013,2012-08-25 00:00:00,Aston Villa,Everton,1,3,2.9,3.4,2.4,1,7,3,9,10,9,1,0,1,0,9,22,0,9,50.0,50.0,4,8,12,19,1,1,31,9
1532,3360,2,2012/2013,2012-08-25 00:00:00,Chelsea,Newcastle United,2,0,1.5,4.33,6.5,4,3,7,8,6,14,1,0,0,0,11,13,2,3,54.0,46.0,2,7,15,20,1,0,24,5
1533,3362,2,2012/2013,2012-08-25 00:00:00,Manchester United,Fulham,3,2,1.29,5.5,11.0,7,7,9,3,9,7,0,1,0,0,40,16,8,8,61.0,39.0,5,14,12,16,1,0,56,16
1534,3363,2,2012/2013,2012-08-25 00:00:00,Norwich City,Queens Park Rangers,1,1,2.25,3.4,3.2,4,2,9,1,17,15,0,2,0,0,25,16,6,2,50.0,50.0,2,6,10,32,2,0,41,8
1535,3364,2,2012/2013,2012-08-25 00:00:00,Southampton,Wigan Athletic,0,2,2.1,3.4,3.5,12,8,5,4,10,9,0,0,0,0,30,13,10,3,47.0,53.0,2,20,9,19,0,0,43,13
1536,3367,2,2012/2013,2012-08-25 00:00:00,Swansea City,West Ham United,3,0,2.1,3.3,3.6,3,6,5,3,14,19,2,4,0,0,10,23,5,4,61.0,39.0,3,9,8,33,6,0,33,9
1537,3368,2,2012/2013,2012-08-25 00:00:00,Tottenham Hotspur,West Bromwich Albion,1,1,1.5,4.33,6.5,11,7,8,5,9,6,1,2,0,0,28,17,7,5,59.0,41.0,2,18,13,15,3,0,45,12
1538,3361,2,2012/2013,2012-08-26 00:00:00,Liverpool,Manchester City,2,2,3.1,3.4,2.3,6,3,9,7,10,8,1,0,0,0,18,19,4,4,49.0,51.0,4,9,16,18,1,0,37,8
1539,3365,2,2012/2013,2012-08-26 00:00:00,Stoke City,Arsenal,0,0,3.5,3.4,2.1,4,5,2,14,12,9,2,0,0,0,25,26,0,11,33.0,67.0,0,9,16,21,2,0,51,11
1540,3471,3,2012/2013,2012-09-01 00:00:00,Manchester City,Queens Park Rangers,3,1,1.18,7.0,15.0,6,5,4,4,12,3,2,1,0,0,18,14,8,3,53.0,47.0,4,11,8,15,3,0,32,11
1541,3474,3,2012/2013,2012-09-01 00:00:00,Swansea City,Sunderland,2,2,2.2,3.3,3.4,8,3,4,2,13,6,1,1,1,0,31,11,8,0,59.0,41.0,4,11,6,19,2,1,42,8
1542,3475,3,2012/2013,2012-09-01 00:00:00,Tottenham Hotspur,Norwich City,1,1,1.36,5.0,8.5,6,4,7,7,7,5,1,0,1,0,14,13,4,2,58.0,42.0,2,10,14,12,1,1,27,6
1543,3476,3,2012/2013,2012-09-01 00:00:00,West Bromwich Albion,Everton,2,0,3.0,3.3,2.38,4,7,7,6,8,10,1,4,0,0,19,26,6,3,63.0,37.0,2,11,13,18,5,0,45,9
1544,3477,3,2012/2013,2012-09-01 00:00:00,West Ham United,Fulham,3,0,2.5,3.25,2.88,7,12,8,3,12,4,0,0,0,0,26,23,6,6,50.0,50.0,3,19,11,16,0,0,49,12
1545,3478,3,2012/2013,2012-09-01 00:00:00,Wigan Athletic,Stoke City,2,2,2.25,3.25,3.3,7,9,5,9,14,11,1,2,0,0,11,22,2,1,61.0,39.0,4,16,14,25,3,0,33,3
1546,3470,3,2012/2013,2012-09-02 00:00:00,Liverpool,Arsenal,0,2,2.0,3.5,3.75,7,5,10,4,13,6,2,2,0,0,31,16,10,2,54.0,46.0,2,12,14,19,4,0,47,12
1547,3472,3,2012/2013,2012-09-02 00:00:00,Newcastle United,Aston Villa,1,1,1.62,3.75,6.0,7,8,10,5,4,13,1,4,0,0,38,19,10,5,54.0,46.0,2,15,15,17,5,0,57,15
1548,3473,3,2012/2013,2012-09-02 00:00:00,Southampton,Manchester United,2,3,6.0,4.2,1.53,3,5,8,10,7,3,1,0,0,0,11,21,4,7,43.0,57.0,5,8,18,10,1,0,32,11
1549,3569,4,2012/2013,2012-09-15 00:00:00,Arsenal,Southampton,6,1,1.36,5.0,8.5,10,6,11,5,4,7,0,0,0,0,22,14,8,3,60.0,40.0,7,16,16,11,0,0,36,11
1550,3570,4,2012/2013,2012-09-15 00:00:00,Aston Villa,Swansea City,2,0,2.38,3.25,3.1,10,3,7,6,11,4,3,1,0,0,29,21,10,4,49.0,51.0,2,13,13,15,4,0,50,14
1551,3572,4,2012/2013,2012-09-15 00:00:00,Fulham,West Bromwich Albion,3,0,2.1,3.4,3.5,11,7,12,1,7,7,0,0,0,1,23,8,5,3,53.0,47.0,3,18,13,14,0,1,31,8
1552,3573,4,2012/2013,2012-09-15 00:00:00,Manchester United,Wigan Athletic,4,0,1.25,6.0,12.0,6,4,9,5,11,13,2,2,0,0,29,19,5,5,55.0,45.0,4,10,14,24,4,0,48,10
1553,3574,4,2012/2013,2012-09-15 00:00:00,Norwich City,West Ham United,0,0,2.38,3.4,3.0,16,5,10,10,11,14,0,1,0,0,21,26,8,5,52.0,48.0,0,21,20,25,1,0,47,13
1554,3575,4,2012/2013,2012-09-15 00:00:00,Queens Park Rangers,Chelsea,0,0,4.5,3.5,1.83,7,9,4,4,16,18,0,2,0,0,19,15,2,4,49.0,51.0,0,16,8,34,2,0,34,6
1555,3577,4,2012/2013,2012-09-15 00:00:00,Stoke City,Manchester City,1,1,5.0,3.6,1.73,3,9,2,4,12,11,0,1,0,0,20,23,6,5,46.0,54.0,2,12,6,23,1,0,43,11
1556,3578,4,2012/2013,2012-09-15 00:00:00,Sunderland,Liverpool,1,1,3.4,3.3,2.2,3,8,2,13,13,13,1,2,0,0,13,25,2,7,45.0,55.0,2,11,15,26,3,0,38,9
1557,3576,4,2012/2013,2012-09-16 00:00:00,Reading,Tottenham Hotspur,1,3,3.75,3.5,2.0,1,8,2,11,5,10,0,1,0,0,26,14,7,4,42.0,58.0,4,9,13,15,1,0,40,11
1558,3571,4,2012/2013,2012-09-17 00:00:00,Everton,Newcastle United,2,2,1.73,3.6,5.0,6,3,9,6,15,11,3,3,0,0,11,10,3,3,59.0,41.0,4,9,15,26,6,0,21,6
1559,3579,5,2012/2013,2012-09-22 00:00:00,Chelsea,Stoke City,1,0,1.36,4.75,9.0,10,3,9,9,13,18,2,1,0,0,28,21,13,3,52.0,48.0,1,13,18,31,3,0,49,16
1560,3583,5,2012/2013,2012-09-22 00:00:00,Southampton,Aston Villa,4,1,2.4,3.3,3.0,3,3,9,6,4,13,1,3,0,0,23,17,1,4,47.0,53.0,5,6,15,17,4,0,40,5
1561,3584,5,2012/2013,2012-09-22 00:00:00,Swansea City,Everton,0,3,3.0,3.3,2.4,7,15,10,12,23,9,5,1,0,0,23,30,8,4,54.0,46.0,3,22,22,32,6,0,53,12
1562,3586,5,2012/2013,2012-09-22 00:00:00,West Bromwich Albion,Reading,1,0,1.73,3.75,4.75,5,1,5,8,15,7,1,0,0,0,31,25,9,1,50.0,50.0,1,6,13,22,1,0,56,10
1563,3587,5,2012/2013,2012-09-22 00:00:00,West Ham United,Sunderland,1,1,2.1,3.3,3.6,8,0,9,3,12,13,2,1,0,0,50,9,10,1,56.0,44.0,2,8,12,25,3,0,59,11
1564,3588,5,2012/2013,2012-09-22 00:00:00,Wigan Athletic,Fulham,1,2,2.4,3.3,3.0,4,6,7,5,6,9,0,3,0,0,18,13,8,7,60.0,40.0,3,10,12,15,3,0,31,15
1565,3580,5,2012/2013,2012-09-23 00:00:00,Liverpool,Manchester United,1,2,2.7,3.3,2.63,7,4,6,4,14,6,1,2,1,0,29,16,7,3,54.0,46.0,3,11,10,20,3,1,45,10
1566,3581,5,2012/2013,2012-09-23 00:00:00,Manchester City,Arsenal,1,1,1.75,3.6,4.75,9,5,5,6,13,6,1,0,0,0,24,18,9,4,53.0,47.0,2,14,11,19,1,0,42,13
1567,3582,5,2012/2013,2012-09-23 00:00:00,Newcastle United,Norwich City,1,0,1.8,3.6,4.5,7,5,7,3,5,9,1,1,0,0,12,10,3,5,55.0,45.0,1,12,10,14,2,0,22,8
1568,3585,5,2012/2013,2012-09-23 00:00:00,Tottenham Hotspur,Queens Park Rangers,2,1,1.44,4.33,7.5,11,5,7,3,6,12,0,2,0,0,21,20,10,9,53.0,47.0,3,16,10,18,2,0,41,19
1569,3589,6,2012/2013,2012-09-29 00:00:00,Arsenal,Chelsea,1,2,2.1,3.4,3.5,3,3,13,5,13,12,2,3,0,0,24,15,6,5,48.0,52.0,3,6,18,25,5,0,39,11
1570,3591,6,2012/2013,2012-09-29 00:00:00,Everton,Southampton,3,1,1.4,4.75,8.0,5,3,8,7,4,5,0,0,0,0,23,7,10,3,56.0,44.0,4,8,15,9,0,0,30,13
1571,3592,6,2012/2013,2012-09-29 00:00:00,Fulham,Manchester City,1,2,4.33,3.6,1.83,3,8,4,10,7,11,0,1,0,0,3,16,2,4,38.0,62.0,3,11,14,18,1,0,19,6
1572,3593,6,2012/2013,2012-09-29 00:00:00,Manchester United,Tottenham Hotspur,2,3,1.57,4.0,6.0,8,1,8,6,7,9,0,0,0,0,42,11,9,5,74.0,26.0,5,9,14,16,0,0,53,14
1573,3594,6,2012/2013,2012-09-29 00:00:00,Norwich City,Liverpool,2,5,4.75,3.75,1.73,7,7,6,4,10,5,1,0,0,0,20,14,5,5,43.0,57.0,7,14,10,15,1,0,34,10
1574,3596,6,2012/2013,2012-09-29 00:00:00,Reading,Newcastle United,2,2,2.88,3.3,2.5,2,1,9,3,10,12,0,3,0,0,11,5,6,3,50.0,50.0,4,3,12,22,3,0,16,9
1575,3597,6,2012/2013,2012-09-29 00:00:00,Stoke City,Swansea City,2,0,1.91,3.4,4.2,6,4,4,7,18,10,1,1,0,0,37,24,6,8,40.0,60.0,2,10,11,28,2,0,61,14
1576,3598,6,2012/2013,2012-09-29 00:00:00,Sunderland,Wigan Athletic,1,0,2.0,3.4,3.8,2,4,9,7,22,17,2,5,0,1,25,11,8,1,55.0,45.0,1,6,16,39,7,1,36,9
1577,3590,6,2012/2013,2012-09-30 00:00:00,Aston Villa,West Bromwich Albion,1,1,2.4,3.3,3.0,6,5,13,8,7,12,1,1,0,0,35,17,11,4,51.0,49.0,2,11,21,19,2,0,52,15
1578,3595,6,2012/2013,2012-10-01 00:00:00,Queens Park Rangers,West Ham United,1,2,2.05,3.4,3.75,7,6,5,8,13,19,2,8,0,0,18,30,4,13,49.0,51.0,3,13,13,32,10,0,48,17
1579,3599,7,2012/2013,2012-10-06 00:00:00,Chelsea,Norwich City,4,1,1.22,6.5,12.0,12,2,7,5,7,1,0,0,0,0,27,15,10,2,62.0,38.0,5,14,12,8,0,0,42,12
1580,3601,7,2012/2013,2012-10-06 00:00:00,Manchester City,Sunderland,3,0,1.29,5.5,11.0,10,6,15,3,14,12,0,3,0,0,29,13,15,4,61.0,39.0,3,16,18,26,3,0,42,19
1581,3604,7,2012/2013,2012-10-06 00:00:00,Swansea City,Reading,2,2,1.91,3.6,4.0,12,11,11,2,7,11,1,3,0,0,27,19,11,3,60.0,40.0,4,23,13,18,4,0,46,14
1582,3606,7,2012/2013,2012-10-06 00:00:00,West Bromwich Albion,Queens Park Rangers,3,2,1.83,3.75,4.2,5,6,5,6,18,13,2,2,0,0,15,19,2,5,45.0,55.0,5,11,11,31,4,0,34,7
1583,3607,7,2012/2013,2012-10-06 00:00:00,West Ham United,Arsenal,1,3,4.0,3.6,1.91,2,8,4,10,8,6,3,2,0,0,13,33,4,14,45.0,55.0,4,10,14,14,5,0,46,18
1584,3608,7,2012/2013,2012-10-06 00:00:00,Wigan Athletic,Everton,2,2,4.2,3.4,1.91,2,10,6,6,14,17,2,5,0,0,19,24,7,6,52.0,48.0,4,12,12,31,7,0,43,13
1585,3600,7,2012/2013,2012-10-07 00:00:00,Liverpool,Stoke City,0,0,1.44,4.33,7.5,8,3,9,1,9,17,0,6,0,0,26,14,5,5,62.0,38.0,0,11,10,26,6,0,40,10
1586,3602,7,2012/2013,2012-10-07 00:00:00,Newcastle United,Manchester United,0,3,4.2,3.75,1.83,2,5,13,6,14,10,4,4,0,0,33,13,6,5,44.0,56.0,3,7,19,24,8,0,46,11
1587,3603,7,2012/2013,2012-10-07 00:00:00,Southampton,Fulham,2,2,2.75,3.3,2.6,5,5,6,11,14,7,4,0,0,0,27,23,8,8,42.0,58.0,4,10,17,21,4,0,50,16
1588,3605,7,2012/2013,2012-10-07 00:00:00,Tottenham Hotspur,Aston Villa,2,0,1.44,4.33,7.5,5,3,15,4,7,7,1,3,0,0,32,5,8,0,58.0,42.0,2,8,19,14,4,0,37,8
1589,3609,8,2012/2013,2012-10-20 00:00:00,Fulham,Aston Villa,1,0,1.8,3.6,4.5,5,2,12,8,6,7,1,2,0,0,20,14,6,4,53.0,47.0,1,7,20,13,3,0,34,10
1590,3610,8,2012/2013,2012-10-20 00:00:00,Liverpool,Reading,1,0,1.33,5.0,10.0,6,8,17,6,13,7,1,1,0,0,16,17,5,5,56.0,44.0,1,14,23,20,2,0,33,10
1591,3611,8,2012/2013,2012-10-20 00:00:00,Manchester United,Stoke City,4,2,1.29,5.5,11.0,5,4,7,2,9,8,1,1,0,0,15,27,3,3,65.0,35.0,6,9,9,17,2,0,42,6
1592,3612,8,2012/2013,2012-10-20 00:00:00,Norwich City,Arsenal,1,0,6.0,4.2,1.53,2,7,3,8,11,8,4,0,0,0,5,17,1,9,38.0,62.0,1,9,11,19,4,0,22,10
1593,3615,8,2012/2013,2012-10-20 00:00:00,Swansea City,Wigan Athletic,2,1,2.1,3.4,3.5,7,8,9,3,11,10,2,3,0,0,23,12,8,3,51.0,49.0,3,15,12,21,5,0,35,11
1594,3616,8,2012/2013,2012-10-20 00:00:00,Tottenham Hotspur,Chelsea,2,4,2.5,3.4,2.75,13,3,8,4,7,8,3,2,0,0,26,21,7,4,47.0,53.0,6,16,12,15,5,0,47,11
1595,3617,8,2012/2013,2012-10-20 00:00:00,West Bromwich Albion,Manchester City,1,2,5.0,3.75,1.7,4,10,7,10,12,13,4,3,0,1,16,27,6,9,43.0,57.0,3,14,17,25,7,1,43,15
1596,3618,8,2012/2013,2012-10-20 00:00:00,West Ham United,Southampton,4,1,1.83,3.75,4.2,5,3,1,7,11,14,0,2,0,0,23,20,6,3,48.0,52.0,5,8,8,25,2,0,43,9
1597,3613,8,2012/2013,2012-10-21 00:00:00,Queens Park Rangers,Everton,1,1,3.25,3.4,2.2,4,5,5,7,7,15,2,1,0,0,13,14,5,4,56.0,44.0,2,9,12,22,3,0,27,9
1598,3614,8,2012/2013,2012-10-21 00:00:00,Sunderland,Newcastle United,1,1,2.5,3.3,2.88,1,4,12,3,8,12,0,4,0,1,23,10,8,4,53.0,47.0,2,5,15,20,4,1,33,12
1599,3619,9,2012/2013,2012-10-27 00:00:00,Arsenal,Queens Park Rangers,1,0,1.36,5.0,8.5,12,3,7,2,16,10,1,2,0,1,19,9,4,2,66.0,34.0,1,15,9,26,3,1,28,6
1600,3620,9,2012/2013,2012-10-27 00:00:00,Aston Villa,Norwich City,1,1,2.0,3.5,3.75,4,4,2,10,9,6,2,0,0,0,9,26,3,8,46.0,54.0,2,8,12,15,2,0,35,11
1601,3623,9,2012/2013,2012-10-27 00:00:00,Manchester City,Swansea City,1,0,1.22,6.0,15.0,3,4,5,3,9,9,1,2,0,0,12,10,3,0,50.0,50.0,1,7,8,18,3,0,22,3
1602,3625,9,2012/2013,2012-10-27 00:00:00,Reading,Fulham,3,3,2.75,3.4,2.5,3,2,7,10,4,15,1,1,0,0,19,23,6,8,46.0,54.0,6,5,17,19,2,0,42,14
1603,3627,9,2012/2013,2012-10-27 00:00:00,Stoke City,Sunderland,0,0,1.95,3.3,4.2,8,2,6,4,12,5,2,2,0,0,32,16,7,3,52.0,48.0,0,10,10,17,4,0,48,10
1604,3628,9,2012/2013,2012-10-27 00:00:00,Wigan Athletic,West Ham United,2,1,2.25,3.4,3.2,13,6,8,11,11,17,3,4,0,0,18,37,6,6,54.0,46.0,3,19,19,28,7,0,55,12
1605,3621,9,2012/2013,2012-10-28 00:00:00,Chelsea,Manchester United,2,3,2.4,3.4,2.9,9,5,2,9,16,11,2,2,1,0,26,18,8,6,51.0,49.0,5,14,11,27,4,1,44,14
1606,3622,9,2012/2013,2012-10-28 00:00:00,Everton,Liverpool,2,2,2.6,3.3,2.75,4,4,11,6,15,17,4,3,0,0,33,22,9,5,56.0,44.0,4,8,17,32,7,0,55,14
1607,3624,9,2012/2013,2012-10-28 00:00:00,Newcastle United,West Bromwich Albion,2,1,2.0,3.5,3.75,6,3,4,5,13,7,3,2,0,0,23,22,6,4,50.0,50.0,3,9,9,20,5,0,45,10
1608,3626,9,2012/2013,2012-10-28 00:00:00,Southampton,Tottenham Hotspur,1,2,4.2,3.75,1.83,5,2,6,8,15,11,0,3,0,0,33,19,2,3,52.0,48.0,3,7,14,26,3,0,52,5
1609,3259,10,2012/2013,2012-11-03 00:00:00,Fulham,Everton,2,2,2.75,3.4,2.5,7,14,2,12,18,9,3,1,0,0,14,42,5,9,41.0,59.0,4,21,14,27,4,0,56,14
1610,3261,10,2012/2013,2012-11-03 00:00:00,Manchester United,Arsenal,2,1,1.7,3.8,5.0,6,1,4,4,14,15,5,3,0,0,28,16,6,1,48.0,52.0,3,7,8,29,8,0,44,7
1611,3262,10,2012/2013,2012-11-03 00:00:00,Norwich City,Stoke City,1,0,2.6,3.3,2.75,11,3,3,6,12,14,1,5,0,0,26,22,9,2,52.0,48.0,1,14,9,26,6,0,48,11
1612,3264,10,2012/2013,2012-11-03 00:00:00,Sunderland,Aston Villa,0,1,2.1,3.3,3.6,3,4,12,4,9,16,2,3,0,0,40,23,6,7,54.0,46.0,1,7,16,25,5,0,63,13
1613,3265,10,2012/2013,2012-11-03 00:00:00,Swansea City,Chelsea,1,1,4.5,3.6,1.8,7,7,3,2,11,11,4,1,0,0,17,18,8,6,50.0,50.0,2,14,5,22,5,0,35,14
1614,3266,10,2012/2013,2012-11-03 00:00:00,Tottenham Hotspur,Wigan Athletic,0,1,1.5,4.33,6.5,8,4,5,3,12,12,1,1,0,0,34,10,9,2,49.0,51.0,1,12,8,24,2,0,44,11
1615,3268,10,2012/2013,2012-11-03 00:00:00,West Ham United,Manchester City,0,0,5.0,3.8,1.7,0,11,6,11,11,12,3,0,0,0,25,27,3,7,42.0,58.0,0,11,17,23,3,0,52,10
1616,3260,10,2012/2013,2012-11-04 00:00:00,Liverpool,Newcastle United,1,1,1.57,4.0,6.0,11,2,9,7,12,14,0,0,0,1,30,9,14,3,58.0,42.0,2,13,16,26,0,1,39,17
1617,3263,10,2012/2013,2012-11-04 00:00:00,Queens Park Rangers,Reading,1,1,1.8,3.6,4.5,10,4,12,12,12,15,0,2,0,0,25,24,8,8,55.0,45.0,2,14,24,27,2,0,49,16
1618,3267,10,2012/2013,2012-11-05 00:00:00,West Bromwich Albion,Southampton,2,0,1.73,3.75,4.75,3,5,10,4,7,9,1,0,0,0,14,21,8,6,49.0,51.0,2,8,14,16,1,0,35,14
1619,3269,11,2012/2013,2012-11-10 00:00:00,Arsenal,Fulham,3,3,1.53,4.2,6.0,6,3,7,5,10,12,1,2,0,0,32,17,8,6,60.0,40.0,6,9,12,22,3,0,49,14
1620,3270,11,2012/2013,2012-11-10 00:00:00,Aston Villa,Manchester United,2,3,7.0,4.5,1.44,3,8,4,10,13,8,1,1,0,0,22,39,5,6,34.0,66.0,5,11,14,21,2,0,61,11
1621,3272,11,2012/2013,2012-11-10 00:00:00,Everton,Sunderland,2,1,1.44,4.2,8.0,9,2,5,2,11,10,1,3,0,0,25,11,6,2,56.0,44.0,3,11,7,21,4,0,36,8
1622,3275,11,2012/2013,2012-11-10 00:00:00,Reading,Norwich City,0,0,2.25,3.4,3.2,2,3,8,9,10,17,0,1,0,0,40,25,10,3,56.0,44.0,0,5,17,27,1,0,65,13
1623,3276,11,2012/2013,2012-11-10 00:00:00,Southampton,Swansea City,1,1,2.38,3.5,2.88,6,2,7,3,12,13,2,2,0,0,31,15,10,6,47.0,53.0,2,8,10,25,4,0,46,16
1624,3277,11,2012/2013,2012-11-10 00:00:00,Stoke City,Queens Park Rangers,1,0,1.91,3.4,4.2,6,4,5,10,11,16,2,3,0,0,30,16,5,5,49.0,51.0,1,10,15,27,5,0,46,10
1625,3278,11,2012/2013,2012-11-10 00:00:00,Wigan Athletic,West Bromwich Albion,1,2,2.3,3.4,3.1,3,4,7,3,13,11,1,4,0,0,25,21,5,8,55.0,45.0,3,7,10,24,5,0,46,13
1626,3271,11,2012/2013,2012-11-11 00:00:00,Chelsea,Liverpool,1,1,1.95,3.5,4.0,3,5,9,3,10,13,1,3,0,0,21,13,4,7,47.0,53.0,2,8,12,23,4,0,34,11
1627,3273,11,2012/2013,2012-11-11 00:00:00,Manchester City,Tottenham Hotspur,2,1,1.57,4.0,6.0,5,1,7,5,14,9,1,2,0,0,22,12,8,2,55.0,45.0,3,6,12,23,3,0,34,10
1628,3274,11,2012/2013,2012-11-11 00:00:00,Newcastle United,West Ham United,0,1,1.95,3.6,3.8,9,4,6,6,10,11,1,2,0,0,40,22,11,3,52.0,48.0,1,13,12,21,3,0,62,14
1629,3279,12,2012/2013,2012-11-17 00:00:00,Arsenal,Tottenham Hotspur,5,2,1.91,3.75,3.8,5,4,3,3,12,13,1,2,0,1,30,14,6,6,54.0,46.0,7,9,6,25,3,1,44,12
1630,3281,12,2012/2013,2012-11-17 00:00:00,Liverpool,Wigan Athletic,3,0,1.44,4.33,7.5,7,3,13,6,8,11,0,3,0,0,23,10,10,5,56.0,44.0,3,10,19,19,3,0,33,15
1631,3282,12,2012/2013,2012-11-17 00:00:00,Manchester City,Aston Villa,5,0,1.2,6.5,15.0,8,8,11,1,7,5,0,1,0,0,25,16,9,4,60.0,40.0,5,16,12,12,1,0,41,13
1632,3283,12,2012/2013,2012-11-17 00:00:00,Newcastle United,Swansea City,1,2,1.91,3.6,4.0,13,6,15,6,9,7,1,3,0,0,28,13,5,4,52.0,48.0,3,19,21,16,4,0,41,9
1633,3284,12,2012/2013,2012-11-17 00:00:00,Norwich City,Manchester United,1,0,7.0,4.5,1.44,3,6,4,4,6,3,0,1,0,0,6,27,0,12,50.0,50.0,1,9,8,9,1,0,33,12
1634,3285,12,2012/2013,2012-11-17 00:00:00,Queens Park Rangers,Southampton,1,3,1.91,3.6,4.0,4,6,5,9,8,5,1,0,0,0,15,25,4,13,49.0,51.0,4,10,14,13,1,0,40,17
1635,3286,12,2012/2013,2012-11-17 00:00:00,Reading,Everton,2,1,4.33,3.6,1.83,1,7,6,6,4,5,3,2,0,0,11,23,6,14,42.0,58.0,3,8,12,9,5,0,34,20
1636,3287,12,2012/2013,2012-11-17 00:00:00,West Bromwich Albion,Chelsea,2,1,3.75,3.5,2.0,4,10,2,9,5,11,0,0,0,0,6,35,0,12,48.0,52.0,3,14,11,16,0,0,41,12
1637,3280,12,2012/2013,2012-11-18 00:00:00,Fulham,Sunderland,1,3,1.67,3.75,5.25,9,4,7,3,10,12,1,3,1,0,19,13,4,4,46.0,54.0,4,13,10,22,4,1,32,8
1638,3288,12,2012/2013,2012-11-19 00:00:00,West Ham United,Stoke City,1,1,2.0,3.4,3.8,8,5,6,5,9,10,1,0,0,0,42,18,12,4,54.0,46.0,2,13,11,19,1,0,60,16
1639,3289,13,2012/2013,2012-11-24 00:00:00,Aston Villa,Arsenal,0,0,4.75,3.75,1.73,5,6,3,6,4,9,1,0,0,0,21,25,6,6,55.0,45.0,0,11,9,13,1,0,46,12
1640,3291,13,2012/2013,2012-11-24 00:00:00,Everton,Norwich City,1,1,1.44,4.33,7.5,8,5,7,4,12,18,0,3,0,0,17,12,4,2,50.0,50.0,2,13,11,30,3,0,29,6
1641,3292,13,2012/2013,2012-11-24 00:00:00,Manchester United,Queens Park Rangers,3,1,1.17,7.5,15.0,7,7,6,5,5,10,1,1,0,0,27,13,9,7,60.0,40.0,4,14,11,15,2,0,40,16
1642,3294,13,2012/2013,2012-11-24 00:00:00,Stoke City,Fulham,1,0,2.2,3.3,3.4,4,4,10,3,16,11,1,1,0,0,31,21,6,3,50.0,50.0,1,8,13,27,2,0,52,9
1643,3295,13,2012/2013,2012-11-24 00:00:00,Sunderland,West Bromwich Albion,2,4,2.5,3.3,2.88,8,3,7,5,11,16,2,3,0,0,38,10,7,2,50.0,50.0,6,11,12,27,5,0,48,9
1644,3298,13,2012/2013,2012-11-24 00:00:00,Wigan Athletic,Reading,3,2,1.83,3.6,4.33,9,9,9,6,17,9,2,0,0,0,27,25,9,5,58.0,42.0,5,18,15,26,2,0,52,14
1645,3290,13,2012/2013,2012-11-25 00:00:00,Chelsea,Manchester City,0,0,2.5,3.5,2.7,1,6,4,3,11,15,0,3,0,0,20,25,6,11,45.0,55.0,0,7,7,26,3,0,45,17
1646,3293,13,2012/2013,2012-11-25 00:00:00,Southampton,Newcastle United,2,0,2.3,3.5,3.0,8,3,9,4,11,15,2,2,0,0,9,29,4,3,50.0,50.0,2,11,13,26,4,0,38,7
1647,3296,13,2012/2013,2012-11-25 00:00:00,Swansea City,Liverpool,0,0,3.4,3.5,2.1,8,10,8,8,6,7,1,0,0,0,18,16,7,6,50.0,50.0,0,18,16,13,1,0,34,13
1648,3297,13,2012/2013,2012-11-25 00:00:00,Tottenham Hotspur,West Ham United,3,1,1.67,3.75,5.5,11,7,12,5,6,9,1,2,0,0,20,19,4,2,61.0,39.0,4,18,17,15,3,0,39,6
1649,3299,14,2012/2013,2012-11-27 00:00:00,Aston Villa,Reading,1,0,1.95,3.4,4.0,10,7,9,6,11,7,1,0,0,0,35,36,8,5,54.0,46.0,1,17,15,18,1,0,71,13
1650,3303,14,2012/2013,2012-11-27 00:00:00,Sunderland,Queens Park Rangers,0,0,2.25,3.25,3.3,7,10,6,4,11,15,1,3,0,0,24,26,5,8,49.0,51.0,0,17,10,26,4,0,50,13
1651,3300,14,2012/2013,2012-11-28 00:00:00,Manchester United,West Ham United,1,0,1.22,6.5,12.0,11,3,11,7,9,12,1,1,0,0,27,32,5,5,52.0,48.0,1,14,18,21,2,0,59,10
1652,3301,14,2012/2013,2012-11-28 00:00:00,Southampton,Norwich City,1,1,2.0,3.4,3.8,6,9,6,5,12,7,1,1,0,0,26,21,3,6,50.0,50.0,2,15,11,19,2,0,47,9
1653,3302,14,2012/2013,2012-11-28 00:00:00,Stoke City,Newcastle United,2,1,1.91,3.4,4.2,3,6,6,2,12,14,2,2,0,0,38,12,7,2,53.0,47.0,3,9,8,26,4,0,50,9
1654,3304,14,2012/2013,2012-11-28 00:00:00,Swansea City,West Bromwich Albion,3,1,2.3,3.4,3.1,4,0,7,5,10,16,0,4,0,0,17,7,5,2,64.0,36.0,4,4,12,26,4,0,24,7
1655,3305,14,2012/2013,2012-11-28 00:00:00,Tottenham Hotspur,Liverpool,2,1,2.4,3.4,2.88,5,8,7,6,6,13,1,2,0,0,6,32,1,12,47.0,53.0,3,13,13,19,3,0,38,13
1656,3306,14,2012/2013,2012-11-28 00:00:00,Wigan Athletic,Manchester City,0,2,6.0,4.2,1.53,5,5,4,8,12,14,1,1,0,0,20,18,5,6,46.0,54.0,2,10,12,26,2,0,38,11
1657,3307,14,2012/2013,2012-11-28 00:00:00,Chelsea,Fulham,0,0,1.44,4.5,7.0,3,5,10,3,9,9,3,0,0,0,27,4,10,3,58.0,42.0,0,8,13,18,3,0,31,13
1658,3308,14,2012/2013,2012-11-28 00:00:00,Everton,Arsenal,1,1,2.5,3.4,2.75,8,9,4,3,14,8,2,1,0,0,19,19,6,6,53.0,47.0,2,17,7,22,3,0,38,12
1659,3309,15,2012/2013,2012-12-01 00:00:00,Arsenal,Swansea City,0,2,1.44,4.5,7.0,9,7,2,4,7,5,1,0,0,0,24,9,5,5,51.0,49.0,2,16,6,12,1,0,33,10
1660,3310,15,2012/2013,2012-12-01 00:00:00,Fulham,Tottenham Hotspur,0,3,2.88,3.3,2.5,2,2,6,5,9,10,0,2,0,0,17,11,2,1,48.0,52.0,3,4,11,19,2,0,28,3
1661,3311,15,2012/2013,2012-12-01 00:00:00,Liverpool,Southampton,1,0,1.4,4.5,8.5,13,5,10,3,15,8,2,0,0,0,28,12,10,4,67.0,33.0,1,18,13,23,2,0,40,14
1662,3312,15,2012/2013,2012-12-01 00:00:00,Manchester City,Everton,1,1,1.5,4.0,7.0,6,4,5,5,17,10,2,1,0,0,29,12,5,2,56.0,44.0,2,10,10,27,3,0,41,7
1663,3315,15,2012/2013,2012-12-01 00:00:00,Queens Park Rangers,Aston Villa,1,1,1.95,3.5,4.0,11,6,6,5,9,7,1,2,0,0,30,13,11,4,50.0,50.0,2,17,11,16,3,0,43,15
1664,3316,15,2012/2013,2012-12-01 00:00:00,Reading,Manchester United,3,4,7.5,4.75,1.4,6,3,4,5,9,13,1,1,0,0,28,13,6,1,47.0,53.0,7,9,9,22,2,0,41,7
1665,3317,15,2012/2013,2012-12-01 00:00:00,West Bromwich Albion,Stoke City,0,1,2.1,3.25,3.75,9,1,5,3,8,14,0,3,0,0,21,23,5,5,53.0,47.0,1,10,8,22,3,0,44,10
1666,3318,15,2012/2013,2012-12-01 00:00:00,West Ham United,Chelsea,3,1,4.0,3.5,1.91,8,7,2,5,11,8,1,2,0,0,34,14,14,5,45.0,55.0,4,15,7,19,3,0,48,19
1667,3314,15,2012/2013,2012-12-02 00:00:00,Norwich City,Sunderland,2,1,2.1,3.3,3.6,2,6,4,8,10,15,0,2,0,0,14,19,2,6,51.0,49.0,3,8,12,25,2,0,33,8
1668,3313,15,2012/2013,2012-12-03 00:00:00,Newcastle United,Wigan Athletic,3,0,2.0,3.4,3.75,7,3,9,5,12,13,1,3,0,1,19,19,4,4,54.0,46.0,3,10,14,25,4,1,38,8
1669,3319,16,2012/2013,2012-12-08 00:00:00,Arsenal,West Bromwich Albion,2,0,1.5,4.33,6.5,6,2,12,6,12,11,2,3,0,0,34,19,7,4,52.0,48.0,2,8,18,23,5,0,53,11
1670,3320,16,2012/2013,2012-12-08 00:00:00,Aston Villa,Stoke City,0,0,2.4,3.2,3.1,7,0,4,2,7,14,0,1,0,0,30,31,3,2,61.0,39.0,0,7,6,21,1,0,61,5
1671,3324,16,2012/2013,2012-12-08 00:00:00,Southampton,Reading,1,0,1.91,3.6,4.0,9,2,12,4,12,12,0,0,0,0,22,21,7,4,53.0,47.0,1,11,16,24,0,0,43,11
1672,3325,16,2012/2013,2012-12-08 00:00:00,Sunderland,Chelsea,1,3,4.75,3.5,1.8,4,1,4,8,11,14,1,3,0,0,25,14,11,1,44.0,56.0,4,5,12,25,4,0,39,12
1673,3326,16,2012/2013,2012-12-08 00:00:00,Swansea City,Norwich City,3,4,1.8,3.6,4.5,2,8,13,2,12,9,2,1,0,0,30,15,6,2,54.0,46.0,7,10,15,21,3,0,45,8
1674,3328,16,2012/2013,2012-12-08 00:00:00,Wigan Athletic,Queens Park Rangers,2,2,2.3,3.4,3.1,6,2,4,3,6,10,0,1,0,0,28,17,11,4,56.0,44.0,4,8,7,16,1,0,45,15
1675,3321,16,2012/2013,2012-12-09 00:00:00,Everton,Tottenham Hotspur,2,1,2.0,3.5,3.75,8,7,8,4,11,9,3,2,0,0,30,18,4,5,45.0,55.0,3,15,12,20,5,0,48,9
1676,3323,16,2012/2013,2012-12-09 00:00:00,Manchester City,Manchester United,2,3,2.2,3.5,3.2,8,1,5,5,12,9,4,3,0,0,21,14,8,2,53.0,47.0,5,9,10,21,7,0,35,10
1677,3327,16,2012/2013,2012-12-09 00:00:00,West Ham United,Liverpool,2,3,3.0,3.3,2.38,4,7,5,8,11,12,1,2,0,0,33,26,2,5,50.0,50.0,5,11,13,23,3,0,59,7
1678,3322,16,2012/2013,2012-12-10 00:00:00,Fulham,Newcastle United,2,1,1.91,3.6,4.0,6,11,8,8,14,10,0,0,0,0,20,44,5,4,49.0,51.0,3,17,16,24,0,0,64,9
1679,3366,2,2012/2013,2012-12-11 00:00:00,Sunderland,Reading,3,0,2.0,3.5,3.75,8,8,4,7,10,12,2,1,0,0,16,30,6,8,51.0,49.0,3,16,11,22,3,0,46,14
1680,3330,17,2012/2013,2012-12-15 00:00:00,Liverpool,Aston Villa,1,3,1.36,4.75,9.0,16,3,10,2,5,11,1,2,0,0,30,6,7,2,58.0,42.0,4,19,12,16,3,0,36,9
1681,3331,17,2012/2013,2012-12-15 00:00:00,Manchester United,Sunderland,3,1,1.2,6.5,15.0,2,9,12,4,11,12,0,0,0,0,23,30,9,9,56.0,44.0,4,11,16,23,0,0,53,18
1682,3332,17,2012/2013,2012-12-15 00:00:00,Newcastle United,Manchester City,1,3,5.5,3.75,1.67,6,6,11,8,8,17,3,2,0,0,45,9,12,7,54.0,46.0,4,12,19,25,5,0,54,19
1683,3333,17,2012/2013,2012-12-15 00:00:00,Norwich City,Wigan Athletic,2,1,2.2,3.4,3.25,9,5,6,5,8,4,3,1,0,0,21,17,7,3,46.0,54.0,3,14,11,12,4,0,38,10
1684,3334,17,2012/2013,2012-12-15 00:00:00,Queens Park Rangers,Fulham,2,1,2.4,3.4,2.88,4,1,12,3,8,12,1,2,0,0,17,13,3,3,45.0,55.0,3,5,15,20,3,0,30,6
1685,3336,17,2012/2013,2012-12-15 00:00:00,Stoke City,Everton,1,1,3.1,3.2,2.4,8,4,9,5,13,11,1,0,0,0,28,26,4,8,48.0,52.0,2,12,14,24,1,0,54,12
1686,3337,17,2012/2013,2012-12-16 00:00:00,Tottenham Hotspur,Swansea City,1,0,1.62,4.0,5.5,13,0,11,3,13,8,3,3,0,0,19,15,9,3,61.0,39.0,1,13,14,21,6,0,34,12
1687,3338,17,2012/2013,2012-12-16 00:00:00,West Bromwich Albion,West Ham United,0,0,2.0,3.5,3.75,11,3,11,7,13,9,3,3,0,0,17,19,8,2,56.0,44.0,0,14,18,22,6,0,36,10
1688,3335,17,2012/2013,2012-12-17 00:00:00,Reading,Arsenal,2,5,5.5,4.0,1.62,3,12,2,8,7,4,1,1,0,0,16,19,3,7,31.0,69.0,7,15,10,11,2,0,35,10
1689,3340,18,2012/2013,2012-12-22 00:00:00,Liverpool,Fulham,4,0,1.53,4.0,6.5,5,5,10,4,10,6,1,2,0,0,25,9,8,2,60.0,40.0,4,10,14,16,3,0,34,10
1690,3341,18,2012/2013,2012-12-22 00:00:00,Manchester City,Reading,1,0,1.14,8.0,19.0,9,1,13,5,12,12,2,3,0,0,43,19,12,3,62.0,38.0,1,10,18,24,5,0,62,15
1691,3342,18,2012/2013,2012-12-22 00:00:00,Newcastle United,Queens Park Rangers,1,0,2.1,3.4,3.5,6,5,11,0,8,13,3,2,0,0,32,9,10,3,57.0,43.0,1,11,11,21,5,0,41,13
1692,3343,18,2012/2013,2012-12-22 00:00:00,Southampton,Sunderland,0,1,2.0,3.5,3.75,6,5,6,4,12,14,0,3,0,0,32,21,8,5,52.0,48.0,1,11,10,26,3,0,53,13
1693,3345,18,2012/2013,2012-12-22 00:00:00,Tottenham Hotspur,Stoke City,0,0,1.62,3.75,6.0,10,3,11,1,8,11,2,5,0,0,38,19,11,4,57.0,43.0,0,13,12,19,7,0,57,15
1694,3346,18,2012/2013,2012-12-22 00:00:00,West Bromwich Albion,Norwich City,2,1,1.91,3.6,4.0,5,3,5,6,12,9,1,1,0,0,24,23,6,5,74.0,26.0,3,8,11,21,2,0,47,11
1695,3347,18,2012/2013,2012-12-22 00:00:00,West Ham United,Everton,1,2,2.88,3.25,2.5,2,8,3,7,10,7,1,0,1,1,15,19,3,5,38.0,62.0,3,10,10,17,1,2,34,8
1696,3348,18,2012/2013,2012-12-22 00:00:00,Wigan Athletic,Arsenal,0,1,4.75,3.75,1.73,6,7,9,3,15,3,1,1,0,0,33,18,4,5,51.0,49.0,1,13,12,18,2,0,51,9
1697,3339,18,2012/2013,2012-12-23 00:00:00,Chelsea,Aston Villa,8,0,1.33,5.5,8.5,12,3,6,3,6,13,0,0,0,0,18,13,8,4,58.0,42.0,8,15,9,19,0,0,31,12
1698,3344,18,2012/2013,2012-12-23 00:00:00,Swansea City,Manchester United,1,1,5.0,4.0,1.67,8,12,4,8,12,16,2,4,0,0,16,25,3,6,40.0,60.0,2,20,12,28,6,0,41,9
1699,3350,19,2012/2013,2012-12-26 00:00:00,Aston Villa,Tottenham Hotspur,0,4,3.75,3.5,2.0,2,11,2,5,7,5,1,0,0,0,18,34,2,15,38.0,62.0,4,13,7,12,1,0,52,17
1700,3351,19,2012/2013,2012-12-26 00:00:00,Everton,Wigan Athletic,2,1,1.44,4.5,7.0,8,8,11,4,9,10,1,3,0,0,26,14,11,2,56.0,44.0,3,16,15,19,4,0,40,13
1701,3352,19,2012/2013,2012-12-26 00:00:00,Fulham,Southampton,1,1,1.85,3.6,4.2,0,3,8,4,15,11,3,0,0,0,18,25,3,5,50.0,50.0,2,3,12,26,3,0,43,8
1702,3353,19,2012/2013,2012-12-26 00:00:00,Manchester United,Newcastle United,4,3,1.22,6.5,13.0,4,9,7,6,13,17,3,3,0,0,26,23,2,2,53.0,47.0,7,13,13,30,6,0,49,4
1703,3354,19,2012/2013,2012-12-26 00:00:00,Norwich City,Chelsea,0,1,6.0,3.75,1.62,2,8,3,8,5,8,1,1,0,0,22,42,5,7,40.0,60.0,1,10,11,13,2,0,64,12
1704,3355,19,2012/2013,2012-12-26 00:00:00,Queens Park Rangers,West Bromwich Albion,1,2,2.2,3.4,3.25,9,4,12,8,9,11,1,0,0,0,29,19,14,9,54.0,46.0,3,13,20,20,1,0,48,23
1705,3356,19,2012/2013,2012-12-26 00:00:00,Reading,Swansea City,0,0,2.9,3.4,2.38,1,3,2,7,16,16,2,1,0,0,16,13,6,4,27.0,73.0,0,4,9,32,3,0,29,10
1706,3357,19,2012/2013,2012-12-26 00:00:00,Stoke City,Liverpool,3,1,3.4,3.2,2.25,6,9,1,7,11,7,3,1,0,0,28,22,6,8,47.0,53.0,4,15,8,18,4,0,50,14
1707,3358,19,2012/2013,2012-12-26 00:00:00,Sunderland,Manchester City,1,0,6.5,4.0,1.53,5,14,6,9,14,15,1,3,0,0,17,27,3,7,33.0,67.0,1,19,15,29,4,0,44,10
1708,3369,20,2012/2013,2012-12-29 00:00:00,Arsenal,Newcastle United,7,3,1.44,4.5,7.0,3,5,5,2,7,9,0,1,0,0,23,31,5,5,58.0,42.0,10,8,7,16,1,0,54,10
1709,3370,20,2012/2013,2012-12-29 00:00:00,Aston Villa,Wigan Athletic,0,3,2.4,3.25,3.0,4,3,9,4,16,9,3,2,0,0,14,9,4,3,47.0,53.0,3,7,13,25,5,0,23,7
1710,3372,20,2012/2013,2012-12-29 00:00:00,Fulham,Swansea City,1,2,2.1,3.4,3.5,8,6,9,2,13,11,2,1,0,0,30,13,9,8,58.0,42.0,3,14,11,24,3,0,43,17
1711,3373,20,2012/2013,2012-12-29 00:00:00,Manchester United,West Bromwich Albion,2,0,1.3,5.5,10.0,12,11,8,5,10,5,1,0,0,0,22,27,9,6,58.0,42.0,2,23,13,15,1,0,49,15
1712,3374,20,2012/2013,2012-12-29 00:00:00,Norwich City,Manchester City,3,4,6.0,4.0,1.57,4,7,5,4,7,11,3,1,0,1,34,28,4,9,51.0,49.0,7,11,9,18,4,1,62,13
1713,3376,20,2012/2013,2012-12-29 00:00:00,Reading,West Ham United,1,0,2.88,3.25,2.5,0,7,3,6,18,13,3,4,0,0,12,34,2,2,39.0,61.0,1,7,9,31,7,0,46,4
1714,3377,20,2012/2013,2012-12-29 00:00:00,Stoke City,Southampton,3,3,1.8,3.5,4.75,5,5,2,1,6,11,1,2,1,0,32,15,7,4,56.0,44.0,6,10,3,17,3,1,47,11
1715,3378,20,2012/2013,2012-12-29 00:00:00,Sunderland,Tottenham Hotspur,1,2,3.5,3.4,2.1,4,9,3,5,13,16,1,3,0,0,26,23,3,8,46.0,54.0,3,13,8,29,4,0,49,11
1716,3371,20,2012/2013,2012-12-30 00:00:00,Everton,Chelsea,1,2,2.88,3.3,2.5,5,7,8,5,16,14,2,3,0,0,38,17,7,7,48.0,52.0,3,12,13,30,5,0,55,14
1717,3375,20,2012/2013,2012-12-30 00:00:00,Queens Park Rangers,Liverpool,0,3,4.0,3.5,1.91,7,8,8,5,11,9,2,1,0,0,8,23,1,9,40.0,60.0,3,15,13,20,3,0,31,10
1718,3381,21,2012/2013,2013-01-01 00:00:00,Manchester City,Stoke City,3,0,1.29,5.5,11.0,5,1,9,1,5,10,2,2,0,0,22,8,6,2,67.0,33.0,3,6,10,15,4,0,30,8
1719,3383,21,2012/2013,2013-01-01 00:00:00,Southampton,Arsenal,1,1,5.0,3.75,1.7,6,3,2,4,9,7,2,0,0,0,19,22,3,3,47.0,53.0,2,9,6,16,2,0,41,6
1720,3384,21,2012/2013,2013-01-01 00:00:00,Swansea City,Aston Villa,2,2,1.57,4.0,6.0,11,5,11,2,8,21,0,4,0,0,30,10,3,2,66.0,34.0,4,16,13,29,4,0,40,5
1721,3385,21,2012/2013,2013-01-01 00:00:00,Tottenham Hotspur,Reading,3,1,1.33,5.0,10.0,15,2,13,4,8,9,0,0,0,0,26,7,10,3,61.0,39.0,4,17,17,17,0,0,33,13
1722,3386,21,2012/2013,2013-01-01 00:00:00,West Bromwich Albion,Fulham,1,2,2.0,3.5,3.75,7,3,11,6,13,9,0,0,0,0,31,11,10,5,47.0,53.0,3,10,17,22,0,0,42,15
1723,3387,21,2012/2013,2013-01-01 00:00:00,West Ham United,Norwich City,2,1,2.1,3.4,3.5,6,5,7,7,15,11,0,0,0,0,31,19,11,3,55.0,45.0,3,11,14,26,0,0,50,14
1724,3388,21,2012/2013,2013-01-01 00:00:00,Wigan Athletic,Manchester United,0,4,6.0,4.2,1.53,3,7,4,4,13,5,1,1,0,0,14,25,1,6,50.0,50.0,4,10,8,18,2,0,39,7
1725,3379,21,2012/2013,2013-01-02 00:00:00,Chelsea,Queens Park Rangers,0,1,1.2,6.5,15.0,8,4,21,2,13,8,1,1,0,0,36,3,14,2,57.0,43.0,1,12,23,21,2,0,39,16
1726,3380,21,2012/2013,2013-01-02 00:00:00,Liverpool,Sunderland,3,0,1.4,4.5,8.5,14,6,8,1,8,6,0,1,0,0,22,13,9,5,63.0,37.0,3,20,9,14,1,0,35,14
1727,3382,21,2012/2013,2013-01-02 00:00:00,Newcastle United,Everton,1,2,3.0,3.4,2.38,10,12,3,1,21,9,3,2,0,0,23,27,4,6,55.0,45.0,3,22,4,30,5,0,50,10
1728,3390,22,2012/2013,2013-01-12 00:00:00,Aston Villa,Southampton,0,1,2.55,3.5,2.9,6,2,8,5,8,7,1,1,0,0,17,19,9,5,54.0,46.0,1,8,13,15,2,0,36,14
1729,3391,22,2012/2013,2013-01-12 00:00:00,Everton,Swansea City,0,0,1.57,4.2,6.5,7,3,9,1,13,5,1,4,0,0,33,7,7,1,57.0,43.0,0,10,10,18,5,0,40,8
1730,3392,22,2012/2013,2013-01-12 00:00:00,Fulham,Wigan Athletic,1,1,2.05,3.5,4.0,4,8,6,6,8,12,1,1,0,0,22,21,6,8,58.0,42.0,2,12,12,20,2,0,43,14
1731,3394,22,2012/2013,2013-01-12 00:00:00,Norwich City,Newcastle United,0,0,2.2,3.6,3.4,3,3,8,5,5,9,0,1,0,0,22,15,5,4,50.0,50.0,0,6,13,14,1,0,37,9
1732,3395,22,2012/2013,2013-01-12 00:00:00,Queens Park Rangers,Tottenham Hotspur,0,0,4.5,3.8,1.85,2,9,2,10,14,9,1,1,0,0,10,14,2,6,40.0,60.0,0,11,12,23,2,0,24,8
1733,3396,22,2012/2013,2013-01-12 00:00:00,Reading,West Bromwich Albion,3,2,3.0,3.4,2.5,5,3,0,6,6,14,1,1,0,0,28,12,8,4,42.0,58.0,5,8,6,20,2,0,40,12
1734,3397,22,2012/2013,2013-01-12 00:00:00,Stoke City,Chelsea,0,4,4.33,3.5,1.95,4,6,6,3,14,7,1,0,0,0,26,19,6,7,45.0,55.0,4,10,9,21,1,0,45,13
1735,3398,22,2012/2013,2013-01-12 00:00:00,Sunderland,West Ham United,3,0,2.38,3.3,3.3,8,4,6,4,10,13,0,3,0,0,20,26,4,5,58.0,42.0,3,12,10,23,3,0,46,9
1736,3389,22,2012/2013,2013-01-13 00:00:00,Arsenal,Manchester City,0,2,2.63,3.5,2.8,4,6,4,9,14,19,2,4,1,1,31,21,2,7,45.0,55.0,2,10,13,33,6,2,52,9
1737,3393,22,2012/2013,2013-01-13 00:00:00,Manchester United,Liverpool,2,1,1.91,3.8,4.2,6,5,6,7,13,16,1,4,0,0,15,14,3,1,58.0,42.0,3,11,13,29,5,0,29,4
1738,3329,17,2012/2013,2013-01-16 00:00:00,Chelsea,Southampton,2,2,1.25,6.5,15.0,6,0,9,2,12,9,1,0,0,0,14,22,4,3,54.0,46.0,4,6,11,21,1,0,36,7
1739,3400,23,2012/2013,2013-01-19 00:00:00,Liverpool,Norwich City,5,0,1.33,5.5,10.5,8,2,7,3,10,8,1,1,0,0,18,11,9,4,60.0,40.0,5,10,10,18,2,0,29,13
1740,3401,23,2012/2013,2013-01-19 00:00:00,Manchester City,Fulham,2,0,1.25,6.5,14.0,8,0,9,2,14,6,1,2,0,0,14,22,1,2,54.0,46.0,2,8,11,20,3,0,36,3
1741,3402,23,2012/2013,2013-01-19 00:00:00,Newcastle United,Reading,1,2,1.75,4.0,5.0,9,0,8,3,10,10,2,3,0,0,35,12,6,2,55.0,45.0,3,9,11,20,5,0,47,8
1742,3404,23,2012/2013,2013-01-19 00:00:00,Swansea City,Stoke City,3,1,2.2,3.4,3.6,1,4,11,5,12,9,0,0,0,0,21,24,6,6,63.0,37.0,4,5,16,21,0,0,45,12
1743,3406,23,2012/2013,2013-01-19 00:00:00,West Bromwich Albion,Aston Villa,2,2,1.75,4.0,5.0,7,5,17,7,7,10,3,3,0,0,29,24,8,8,46.0,54.0,4,12,24,17,6,0,53,16
1744,3407,23,2012/2013,2013-01-19 00:00:00,West Ham United,Queens Park Rangers,1,1,2.1,3.5,3.75,14,4,8,3,6,12,1,0,0,0,44,4,12,2,60.0,40.0,2,18,11,18,1,0,48,14
1745,3408,23,2012/2013,2013-01-19 00:00:00,Wigan Athletic,Sunderland,2,3,2.15,3.4,3.8,9,7,13,6,10,16,3,2,0,0,30,11,9,0,56.0,44.0,5,16,19,26,5,0,41,9
1746,3399,23,2012/2013,2013-01-20 00:00:00,Chelsea,Arsenal,2,1,1.91,3.6,4.0,7,6,5,4,10,12,2,1,0,0,22,29,3,9,55.0,45.0,3,13,9,22,3,0,51,12
1747,3405,23,2012/2013,2013-01-20 00:00:00,Tottenham Hotspur,Manchester United,1,1,2.9,3.6,2.5,16,3,8,2,9,15,1,4,0,0,37,18,9,4,52.0,48.0,2,19,10,24,5,0,55,13
1748,3403,23,2012/2013,2013-01-21 00:00:00,Southampton,Everton,0,0,3.6,3.5,2.05,7,6,5,4,14,12,2,1,0,0,25,27,10,6,58.0,42.0,0,13,9,26,3,0,52,16
1749,3349,19,2012/2013,2013-01-23 00:00:00,Arsenal,West Ham United,5,1,1.44,4.75,8.0,12,2,9,2,9,9,0,1,0,0,25,16,13,5,63.0,37.0,6,14,11,18,1,0,41,18
1750,3410,24,2012/2013,2013-01-29 00:00:00,Aston Villa,Newcastle United,1,2,2.9,3.4,2.6,8,5,5,7,16,11,5,2,0,0,23,21,3,4,44.0,56.0,3,13,12,27,7,0,44,7
1751,3413,24,2012/2013,2013-01-29 00:00:00,Queens Park Rangers,Manchester City,0,0,7.5,4.5,1.5,2,8,4,8,9,7,2,2,0,0,8,33,2,10,30.0,70.0,0,10,12,16,4,0,41,12
1752,3415,24,2012/2013,2013-01-29 00:00:00,Stoke City,Wigan Athletic,2,2,2.2,3.3,3.75,3,6,5,5,11,10,1,1,0,0,19,21,0,1,38.0,62.0,4,9,10,21,2,0,40,1
1753,3416,24,2012/2013,2013-01-29 00:00:00,Sunderland,Swansea City,0,0,2.5,3.4,3.0,1,8,2,9,11,13,1,2,0,0,16,16,3,4,46.0,54.0,0,9,11,24,3,0,32,7
1754,3409,24,2012/2013,2013-01-30 00:00:00,Arsenal,Liverpool,2,2,2.4,3.5,3.1,7,4,11,5,10,8,3,1,0,0,32,18,8,6,57.0,43.0,4,11,16,18,4,0,50,14
1755,3411,24,2012/2013,2013-01-30 00:00:00,Manchester United,Southampton,2,1,1.25,6.5,14.0,5,9,5,10,7,10,2,1,0,0,19,22,4,8,53.0,47.0,3,14,15,17,3,0,41,12
1756,3412,24,2012/2013,2013-01-30 00:00:00,Norwich City,Tottenham Hotspur,1,1,4.75,3.75,1.83,3,8,6,3,15,13,4,1,0,0,20,26,3,6,44.0,56.0,2,11,9,28,5,0,46,9
1757,3414,24,2012/2013,2013-01-30 00:00:00,Reading,Chelsea,2,2,7.5,4.5,1.5,0,4,3,9,11,17,1,2,0,0,11,15,0,6,32.0,68.0,4,4,12,28,3,0,26,6
1758,3417,24,2012/2013,2013-01-30 00:00:00,Everton,West Bromwich Albion,2,1,1.6,4.1,6.5,6,3,8,4,7,13,0,2,0,0,19,13,5,2,57.0,43.0,3,9,12,20,2,0,32,7
1759,3418,24,2012/2013,2013-01-30 00:00:00,Fulham,West Ham United,3,1,2.2,3.5,3.5,5,3,7,6,7,8,2,0,0,0,9,23,2,8,45.0,55.0,4,8,13,15,2,0,32,10
1760,3419,25,2012/2013,2013-02-02 00:00:00,Arsenal,Stoke City,1,0,1.44,4.5,9.0,12,1,7,5,3,10,0,3,0,0,34,10,11,1,58.0,42.0,1,13,12,13,3,0,44,12
1761,3420,25,2012/2013,2013-02-02 00:00:00,Everton,Aston Villa,3,3,1.4,5.0,9.0,8,0,11,5,6,24,1,4,0,0,52,9,15,2,64.0,36.0,6,8,16,30,5,0,61,17
1762,3421,25,2012/2013,2013-02-02 00:00:00,Fulham,Manchester United,0,1,5.5,4.2,1.65,9,8,8,8,9,15,1,1,0,0,25,31,5,8,36.0,64.0,1,17,16,24,2,0,56,13
1763,3423,25,2012/2013,2013-02-02 00:00:00,Newcastle United,Chelsea,3,2,4.0,3.6,2.0,11,6,5,6,11,6,2,3,0,0,22,19,5,4,43.0,57.0,5,17,11,17,5,0,41,9
1764,3424,25,2012/2013,2013-02-02 00:00:00,Queens Park Rangers,Norwich City,0,0,1.95,3.6,4.33,5,9,8,3,9,17,2,5,0,0,29,19,10,9,52.0,48.0,0,14,11,26,7,0,48,19
1765,3425,25,2012/2013,2013-02-02 00:00:00,Reading,Sunderland,2,1,2.5,3.4,3.0,3,6,6,6,13,14,1,3,0,0,37,29,6,8,50.0,50.0,3,9,12,27,4,0,66,14
1766,3427,25,2012/2013,2013-02-02 00:00:00,West Ham United,Swansea City,1,0,2.4,3.4,3.2,5,4,9,5,4,6,1,1,0,0,23,21,5,3,44.0,56.0,1,9,14,10,2,0,44,8
1767,3428,25,2012/2013,2013-02-02 00:00:00,Wigan Athletic,Southampton,2,2,2.2,3.5,3.5,2,12,2,10,6,17,0,2,0,0,17,26,8,5,55.0,45.0,4,14,12,23,2,0,43,13
1768,3422,25,2012/2013,2013-02-03 00:00:00,Manchester City,Liverpool,2,2,1.83,3.9,4.5,3,9,5,10,15,10,2,4,0,0,23,28,9,10,49.0,51.0,4,12,15,25,6,0,51,19
1769,3426,25,2012/2013,2013-02-03 00:00:00,West Bromwich Albion,Tottenham Hotspur,0,1,3.6,3.4,2.2,3,9,1,12,12,9,1,0,1,0,7,37,2,17,35.0,65.0,1,12,13,21,1,1,44,19
1770,3430,26,2012/2013,2013-02-09 00:00:00,Chelsea,Wigan Athletic,4,1,1.36,5.5,9.5,8,4,9,3,7,10,1,2,0,0,28,13,10,6,68.0,32.0,5,12,12,17,3,0,41,16
1771,3433,26,2012/2013,2013-02-09 00:00:00,Norwich City,Fulham,0,0,2.3,3.4,3.4,8,4,7,3,10,15,2,2,0,0,25,20,3,4,44.0,56.0,0,12,10,25,4,0,45,7
1772,3434,26,2012/2013,2013-02-09 00:00:00,Southampton,Manchester City,3,1,5.75,4.0,1.67,4,5,8,2,11,12,1,2,0,0,21,29,6,6,50.0,50.0,4,9,10,23,3,0,50,12
1773,3435,26,2012/2013,2013-02-09 00:00:00,Stoke City,Reading,2,1,1.91,3.5,4.6,10,3,4,2,10,5,2,0,0,0,42,23,11,3,57.0,43.0,3,13,6,15,2,0,65,14
1774,3436,26,2012/2013,2013-02-09 00:00:00,Sunderland,Arsenal,0,1,4.5,3.6,1.91,7,8,6,9,9,14,3,2,0,0,48,8,11,2,44.0,56.0,1,15,15,23,5,0,56,13
1775,3437,26,2012/2013,2013-02-09 00:00:00,Swansea City,Queens Park Rangers,4,1,1.83,3.75,4.75,9,8,1,7,6,11,1,3,0,0,13,10,5,2,58.0,42.0,5,17,8,17,4,0,23,7
1776,3438,26,2012/2013,2013-02-09 00:00:00,Tottenham Hotspur,Newcastle United,2,1,1.67,4.0,5.75,7,5,8,4,6,11,0,2,0,0,23,22,11,5,51.0,49.0,3,12,12,17,2,0,45,16
1777,3429,26,2012/2013,2013-02-10 00:00:00,Aston Villa,West Ham United,2,1,2.63,3.4,2.88,3,8,5,8,16,13,3,2,0,0,21,40,4,10,46.0,54.0,3,11,13,29,5,0,61,14
1778,3432,26,2012/2013,2013-02-10 00:00:00,Manchester United,Everton,2,0,1.75,3.9,5.0,4,8,4,2,12,13,0,2,0,0,28,27,7,6,53.0,47.0,2,12,6,25,2,0,55,13
1779,3431,26,2012/2013,2013-02-11 00:00:00,Liverpool,West Bromwich Albion,0,2,1.4,5.0,9.0,14,2,12,1,8,10,1,4,0,0,31,12,13,5,59.0,41.0,2,16,13,18,5,0,43,18
1780,3441,27,2012/2013,2013-02-17 00:00:00,Liverpool,Swansea City,5,0,1.57,4.4,6.0,8,3,15,0,3,9,0,1,0,0,25,8,10,1,61.0,39.0,5,11,15,12,1,0,33,11
1781,3439,27,2012/2013,2013-02-23 00:00:00,Arsenal,Aston Villa,2,1,1.33,5.5,11.0,13,4,10,2,5,6,1,2,0,0,47,13,11,2,53.0,47.0,3,17,12,11,3,0,60,13
1782,3440,27,2012/2013,2013-02-23 00:00:00,Fulham,Stoke City,1,0,2.2,3.3,3.75,7,2,12,5,6,11,1,3,0,0,28,22,9,4,55.0,45.0,1,9,17,17,4,0,50,13
1783,3444,27,2012/2013,2013-02-23 00:00:00,Norwich City,Everton,2,1,3.8,3.5,2.1,5,4,2,7,9,8,1,1,0,0,18,16,7,5,43.0,57.0,3,9,9,17,2,0,34,12
1784,3445,27,2012/2013,2013-02-23 00:00:00,Queens Park Rangers,Manchester United,0,2,7.0,4.33,1.53,5,7,8,5,11,8,0,0,0,0,25,22,2,3,51.0,49.0,2,12,13,19,0,0,47,5
1785,3446,27,2012/2013,2013-02-23 00:00:00,Reading,Wigan Athletic,0,3,2.63,3.4,2.88,1,7,6,5,9,11,1,1,1,0,24,25,2,9,39.0,61.0,3,8,11,20,2,1,49,11
1786,3447,27,2012/2013,2013-02-23 00:00:00,West Bromwich Albion,Sunderland,2,1,2.05,3.5,4.0,3,4,10,4,9,5,2,1,0,0,12,10,4,4,49.0,51.0,3,7,14,14,3,0,22,8
1787,3442,27,2012/2013,2013-02-24 00:00:00,Manchester City,Chelsea,2,0,1.95,3.6,4.33,7,4,6,3,18,6,3,1,0,0,25,29,6,6,49.0,51.0,2,11,9,24,4,0,54,12
1788,3443,27,2012/2013,2013-02-24 00:00:00,Newcastle United,Southampton,4,2,2.2,3.5,3.2,4,3,5,4,7,11,0,4,0,0,19,16,7,3,58.0,42.0,6,7,9,18,4,0,35,10
1789,3448,27,2012/2013,2013-02-25 00:00:00,West Ham United,Tottenham Hotspur,2,3,3.6,3.5,2.15,8,12,2,11,11,7,4,1,0,0,28,24,6,12,35.0,65.0,5,20,13,18,5,0,52,18
1790,3450,28,2012/2013,2013-03-02 00:00:00,Chelsea,West Bromwich Albion,1,0,1.4,5.0,9.0,19,5,5,4,13,13,1,2,0,0,30,20,9,7,53.0,47.0,1,24,9,26,3,0,50,16
1791,3451,28,2012/2013,2013-03-02 00:00:00,Everton,Reading,3,1,1.38,5.0,10.0,9,5,7,5,8,8,1,1,0,0,30,30,9,10,57.0,43.0,4,14,12,16,2,0,60,19
1792,3452,28,2012/2013,2013-03-02 00:00:00,Manchester United,Norwich City,4,0,1.33,5.5,11.0,5,0,6,2,4,11,0,4,0,0,25,11,7,3,55.0,45.0,4,5,8,15,4,0,36,10
1793,3453,28,2012/2013,2013-03-02 00:00:00,Southampton,Queens Park Rangers,1,2,1.85,3.8,4.5,11,3,8,2,8,15,1,3,0,0,37,9,6,3,59.0,41.0,3,14,10,23,4,0,46,9
1794,3454,28,2012/2013,2013-03-02 00:00:00,Stoke City,West Ham United,0,1,2.15,3.25,4.0,7,8,6,4,9,13,1,2,0,0,25,14,4,2,49.0,51.0,1,15,10,22,3,0,39,6
1795,3455,28,2012/2013,2013-03-02 00:00:00,Sunderland,Fulham,2,2,2.4,3.3,3.3,3,3,6,3,7,10,1,3,0,0,29,11,7,3,49.0,51.0,4,6,9,17,4,0,40,10
1796,3456,28,2012/2013,2013-03-02 00:00:00,Swansea City,Newcastle United,1,0,2.1,3.6,3.75,5,5,3,6,7,9,0,2,0,0,17,28,7,7,52.0,48.0,1,10,9,16,2,0,45,14
1797,3458,28,2012/2013,2013-03-02 00:00:00,Wigan Athletic,Liverpool,0,4,4.5,3.75,1.85,9,3,6,1,12,15,2,2,0,0,19,14,4,3,50.0,50.0,4,12,7,27,4,0,33,7
1798,3457,28,2012/2013,2013-03-03 00:00:00,Tottenham Hotspur,Arsenal,2,1,2.3,3.6,3.25,5,6,5,7,18,13,3,1,0,0,16,24,4,6,52.0,48.0,3,11,12,31,4,0,40,10
1799,3449,28,2012/2013,2013-03-04 00:00:00,Aston Villa,Manchester City,0,1,7.5,4.5,1.44,3,10,8,9,12,15,2,0,0,0,32,17,6,5,46.0,54.0,1,13,17,27,2,0,49,11
1800,3464,29,2012/2013,2013-03-09 00:00:00,Norwich City,Southampton,0,0,2.5,3.4,3.0,4,8,2,6,10,11,2,3,0,0,20,32,1,7,46.0,54.0,0,12,8,21,5,0,52,8
1801,3465,29,2012/2013,2013-03-09 00:00:00,Queens Park Rangers,Sunderland,3,1,2.25,3.4,3.5,5,2,9,6,4,18,0,2,0,0,24,22,4,5,45.0,55.0,4,7,15,22,2,0,46,9
1802,3466,29,2012/2013,2013-03-09 00:00:00,Reading,Aston Villa,1,2,2.45,3.4,3.1,4,4,6,13,9,9,2,3,0,0,30,12,5,1,45.0,55.0,3,8,19,18,5,0,42,6
1803,3467,29,2012/2013,2013-03-09 00:00:00,West Bromwich Albion,Swansea City,2,1,2.45,3.3,3.2,6,4,5,5,13,9,1,1,0,0,16,19,3,3,45.0,55.0,3,10,10,22,2,0,35,6
1804,3461,29,2012/2013,2013-03-10 00:00:00,Liverpool,Tottenham Hotspur,3,2,1.95,3.8,4.0,3,7,5,8,9,10,1,1,0,0,13,19,1,4,41.0,59.0,5,10,13,19,2,0,32,5
1805,3463,29,2012/2013,2013-03-10 00:00:00,Newcastle United,Stoke City,2,1,1.83,3.7,4.8,5,4,5,1,8,9,1,1,0,0,33,12,14,4,57.0,43.0,3,9,6,17,2,0,45,18
1806,3479,30,2012/2013,2013-03-16 00:00:00,Aston Villa,Queens Park Rangers,3,2,2.3,3.4,3.4,5,7,7,11,15,9,3,2,0,0,26,21,9,6,59.0,41.0,5,12,18,24,5,0,47,15
1807,3481,30,2012/2013,2013-03-16 00:00:00,Everton,Manchester City,2,0,3.9,3.6,2.05,4,13,4,7,19,8,4,3,1,0,28,18,12,6,55.0,45.0,2,17,11,27,7,1,46,18
1808,3482,30,2012/2013,2013-03-16 00:00:00,Manchester United,Reading,1,0,1.17,9.0,19.0,6,3,8,2,7,18,0,2,0,0,23,24,5,4,58.0,42.0,1,9,10,25,2,0,47,9
1809,3483,30,2012/2013,2013-03-16 00:00:00,Southampton,Liverpool,3,1,4.2,3.8,1.91,9,8,6,3,10,10,0,1,0,0,23,15,7,5,56.0,44.0,4,17,9,20,1,0,38,12
1810,3484,30,2012/2013,2013-03-16 00:00:00,Stoke City,West Bromwich Albion,0,0,2.5,3.3,3.1,8,5,8,4,15,13,2,2,0,0,39,16,7,1,56.0,44.0,0,13,12,28,4,0,55,8
1811,3486,30,2012/2013,2013-03-16 00:00:00,Swansea City,Arsenal,0,2,3.4,3.5,2.25,1,6,7,5,2,5,1,1,0,0,11,24,3,7,46.0,54.0,2,7,12,7,2,0,35,10
1812,3480,30,2012/2013,2013-03-17 00:00:00,Chelsea,West Ham United,2,0,1.4,5.0,9.0,11,9,8,5,5,12,0,2,0,0,19,20,5,5,48.0,52.0,2,20,13,17,2,0,39,10
1813,3485,30,2012/2013,2013-03-17 00:00:00,Sunderland,Norwich City,1,1,2.05,3.5,4.0,7,2,8,5,12,12,1,3,0,1,31,23,5,9,50.0,50.0,2,9,13,24,4,1,54,14
1814,3487,30,2012/2013,2013-03-17 00:00:00,Tottenham Hotspur,Fulham,0,1,1.5,4.5,7.5,5,0,7,5,10,8,1,1,0,0,25,14,5,5,58.0,42.0,1,5,12,18,2,0,39,10
1815,3488,30,2012/2013,2013-03-17 00:00:00,Wigan Athletic,Newcastle United,2,1,2.3,3.4,3.4,6,3,7,5,10,13,1,2,0,0,20,23,7,3,52.0,48.0,3,9,12,23,3,0,43,10
1816,3489,31,2012/2013,2013-03-30 00:00:00,Arsenal,Reading,4,1,1.25,6.5,15.0,8,3,9,1,8,10,0,1,0,0,28,15,11,3,69.0,31.0,5,11,10,18,1,0,43,14
1817,3491,31,2012/2013,2013-03-30 00:00:00,Everton,Stoke City,1,0,1.57,3.9,7.5,10,7,5,5,13,18,1,3,0,0,20,25,4,3,54.0,46.0,1,17,10,31,4,0,45,7
1818,3493,31,2012/2013,2013-03-30 00:00:00,Manchester City,Newcastle United,4,0,1.33,5.5,11.0,10,1,7,4,7,8,0,2,0,0,26,14,9,2,64.0,36.0,4,11,11,15,2,0,40,11
1819,3494,31,2012/2013,2013-03-30 00:00:00,Southampton,Chelsea,2,1,3.5,3.5,2.2,5,6,4,3,9,8,2,1,0,0,16,23,7,7,54.0,46.0,3,11,7,17,3,0,39,14
1820,3495,31,2012/2013,2013-03-30 00:00:00,Sunderland,Manchester United,0,1,6.0,4.0,1.65,2,11,7,3,16,8,3,1,0,0,22,21,3,6,51.0,49.0,1,13,10,24,4,0,43,9
1821,3496,31,2012/2013,2013-03-30 00:00:00,Swansea City,Tottenham Hotspur,1,2,3.4,3.4,2.3,4,3,8,2,4,10,2,4,0,0,19,9,5,2,63.0,37.0,3,7,10,14,6,0,28,7
1822,3497,31,2012/2013,2013-03-30 00:00:00,West Ham United,West Bromwich Albion,3,1,2.3,3.4,3.4,5,10,5,7,11,15,1,1,0,1,29,16,5,3,48.0,52.0,4,15,12,26,2,1,45,8
1823,3498,31,2012/2013,2013-03-30 00:00:00,Wigan Athletic,Norwich City,1,0,1.95,3.6,4.33,4,5,9,5,14,12,1,2,0,0,24,19,10,3,46.0,54.0,1,9,14,26,3,0,43,13
1824,3490,31,2012/2013,2013-03-31 00:00:00,Aston Villa,Liverpool,1,2,5.0,4.0,1.75,6,12,5,6,10,9,1,1,0,0,23,15,7,8,45.0,55.0,3,18,11,19,2,0,38,15
1825,3492,31,2012/2013,2013-04-01 00:00:00,Fulham,Queens Park Rangers,3,2,2.0,3.6,4.0,3,8,4,8,10,7,2,1,1,0,13,23,3,6,57.0,43.0,5,11,12,17,3,1,36,9
1826,3503,32,2012/2013,2013-04-06 00:00:00,Norwich City,Swansea City,2,2,2.63,3.3,2.9,4,9,5,6,7,16,5,3,0,0,21,26,2,5,35.0,65.0,4,13,11,23,8,0,47,7
1827,3505,32,2012/2013,2013-04-06 00:00:00,Reading,Southampton,0,2,3.3,3.6,2.25,5,3,5,8,8,11,0,0,0,0,34,17,8,4,42.0,58.0,2,8,13,19,0,0,51,12
1828,3506,32,2012/2013,2013-04-06 00:00:00,Stoke City,Aston Villa,1,3,2.1,3.4,4.0,6,5,7,3,13,13,3,1,0,0,32,10,4,2,48.0,52.0,4,11,10,26,4,0,42,6
1829,3508,32,2012/2013,2013-04-06 00:00:00,West Bromwich Albion,Arsenal,1,2,4.1,3.7,1.95,6,5,11,5,5,13,2,4,0,1,25,9,6,4,49.0,51.0,3,11,16,18,6,1,34,10
1830,3499,32,2012/2013,2013-04-07 00:00:00,Chelsea,Sunderland,2,1,1.36,5.0,11.0,7,2,8,4,8,13,0,2,0,0,30,17,8,5,58.0,42.0,3,9,12,21,2,0,47,13
1831,3500,32,2012/2013,2013-04-07 00:00:00,Liverpool,West Ham United,0,0,1.36,5.5,9.0,10,5,10,7,9,5,0,1,0,0,28,18,12,2,66.0,34.0,0,15,17,14,1,0,46,14
1832,3502,32,2012/2013,2013-04-07 00:00:00,Newcastle United,Fulham,1,0,2.1,3.5,3.8,6,3,12,2,11,8,2,2,0,0,28,14,10,3,47.0,53.0,1,9,14,19,4,0,42,13
1833,3504,32,2012/2013,2013-04-07 00:00:00,Queens Park Rangers,Wigan Athletic,1,1,2.38,3.4,3.25,1,12,5,6,10,13,2,3,1,0,23,24,2,10,47.0,53.0,2,13,11,23,5,1,47,12
1834,3507,32,2012/2013,2013-04-07 00:00:00,Tottenham Hotspur,Everton,2,2,2.2,3.4,3.6,7,2,9,5,17,8,1,1,0,0,34,14,7,6,54.0,46.0,4,9,14,25,2,0,48,13
1835,3501,32,2012/2013,2013-04-08 00:00:00,Manchester United,Manchester City,1,2,2.3,3.5,3.3,7,5,9,6,13,22,3,5,0,0,40,20,9,4,51.0,49.0,3,12,15,35,8,0,60,13
1836,3509,33,2012/2013,2013-04-13 00:00:00,Arsenal,Norwich City,3,1,1.25,6.5,14.0,6,4,5,1,10,11,1,2,0,0,29,15,9,3,53.0,47.0,4,10,6,21,3,0,44,12
1837,3510,33,2012/2013,2013-04-13 00:00:00,Aston Villa,Fulham,1,1,2.3,3.3,3.5,7,3,8,7,5,15,1,2,0,0,36,13,9,5,51.0,49.0,2,10,15,20,3,0,49,14
1838,3512,33,2012/2013,2013-04-13 00:00:00,Everton,Queens Park Rangers,2,0,1.44,4.75,8.0,9,7,3,4,6,12,3,3,0,0,31,16,13,5,60.0,40.0,2,16,7,18,6,0,47,18
1839,3515,33,2012/2013,2013-04-13 00:00:00,Reading,Liverpool,0,0,8.0,4.75,1.45,4,13,3,11,10,9,2,1,0,0,26,22,4,9,39.0,61.0,0,17,14,19,3,0,48,13
1840,3516,33,2012/2013,2013-04-13 00:00:00,Southampton,West Ham United,1,1,1.91,3.75,4.2,13,4,4,2,12,16,2,3,0,0,27,13,7,4,57.0,43.0,2,17,6,28,5,0,40,11
1841,3514,33,2012/2013,2013-04-14 00:00:00,Newcastle United,Sunderland,0,3,1.95,3.5,4.5,7,5,6,0,14,8,3,2,0,0,37,20,10,9,51.0,49.0,3,12,6,22,5,0,57,19
1842,3517,33,2012/2013,2013-04-14 00:00:00,Stoke City,Manchester United,0,2,7.0,3.9,1.6,4,2,8,6,10,10,1,1,0,0,15,12,3,7,44.0,56.0,2,6,14,20,2,0,27,10
1843,3459,29,2012/2013,2013-04-16 00:00:00,Arsenal,Everton,0,0,1.75,3.9,5.0,5,6,4,4,8,11,2,3,0,0,24,11,8,1,55.0,45.0,0,11,8,19,5,0,35,9
1844,3460,29,2012/2013,2013-04-17 00:00:00,Fulham,Chelsea,0,3,4.75,3.8,1.8,6,9,6,4,12,12,2,1,0,0,21,24,6,5,53.0,47.0,3,15,10,24,3,0,45,11
1845,3462,29,2012/2013,2013-04-17 00:00:00,Manchester City,Wigan Athletic,1,0,1.25,6.5,14.0,5,9,8,2,12,7,2,1,0,0,13,13,5,4,50.0,50.0,1,14,10,19,3,0,26,9
1846,3468,29,2012/2013,2013-04-17 00:00:00,West Ham United,Manchester United,2,2,5.5,3.9,1.7,2,8,7,5,13,7,1,0,0,0,22,36,2,5,43.0,57.0,4,10,12,20,1,0,58,7
1847,3519,34,2012/2013,2013-04-20 00:00:00,Fulham,Arsenal,0,1,5.0,4.0,1.75,6,6,2,3,12,8,0,2,1,1,15,22,7,3,38.0,62.0,1,12,5,20,2,2,37,10
1848,3522,34,2012/2013,2013-04-20 00:00:00,Norwich City,Reading,2,1,1.75,3.8,5.25,5,5,10,5,12,13,2,3,0,0,28,20,8,8,45.0,55.0,3,10,15,25,5,0,48,16
1849,3523,34,2012/2013,2013-04-20 00:00:00,Queens Park Rangers,Stoke City,0,2,2.25,3.4,3.5,8,7,19,8,9,15,1,2,0,0,17,21,5,5,54.0,46.0,2,15,27,24,3,0,38,10
1850,3524,34,2012/2013,2013-04-20 00:00:00,Sunderland,Everton,1,0,3.4,3.4,2.3,4,7,5,3,7,16,1,2,0,0,13,25,3,10,51.0,49.0,1,11,8,23,3,0,38,13
1851,3525,34,2012/2013,2013-04-20 00:00:00,Swansea City,Southampton,0,0,2.38,3.5,3.1,7,5,7,3,12,13,0,0,0,0,29,13,7,2,53.0,47.0,0,12,10,25,0,0,42,9
1852,3527,34,2012/2013,2013-04-20 00:00:00,West Bromwich Albion,Newcastle United,1,1,2.25,3.5,3.4,3,5,5,5,9,13,0,2,0,0,26,11,15,2,59.0,41.0,2,8,10,22,2,0,37,17
1853,3528,34,2012/2013,2013-04-20 00:00:00,West Ham United,Wigan Athletic,2,0,2.3,3.5,3.3,7,10,7,8,12,10,3,1,0,0,18,26,3,6,44.0,56.0,2,17,15,22,4,0,44,9
1854,3520,34,2012/2013,2013-04-21 00:00:00,Liverpool,Chelsea,2,2,2.15,3.6,3.6,10,5,10,4,10,11,5,3,0,0,26,11,8,5,47.0,53.0,4,15,14,21,8,0,37,13
1855,3526,34,2012/2013,2013-04-21 00:00:00,Tottenham Hotspur,Manchester City,3,1,3.25,3.6,2.3,6,4,3,6,13,11,3,3,0,0,21,12,4,5,56.0,44.0,4,10,9,24,6,0,33,9
1856,3521,34,2012/2013,2013-04-22 00:00:00,Manchester United,Aston Villa,3,0,1.25,6.75,13.0,3,7,6,5,10,6,1,0,0,0,27,21,5,3,52.0,48.0,3,10,11,16,1,0,48,8
1857,3532,35,2012/2013,2013-04-27 00:00:00,Everton,Fulham,1,0,1.5,4.5,7.5,10,5,10,3,11,18,1,3,0,0,32,15,7,2,60.0,40.0,1,15,13,29,4,0,47,9
1858,3533,35,2012/2013,2013-04-27 00:00:00,Manchester City,West Ham United,2,1,1.29,6.0,12.0,8,3,8,4,8,9,1,3,0,0,17,34,9,4,61.0,39.0,3,11,12,17,4,0,51,13
1859,3534,35,2012/2013,2013-04-27 00:00:00,Newcastle United,Liverpool,0,6,2.88,3.6,2.5,4,5,6,2,13,7,3,2,0,0,23,19,5,7,51.0,49.0,6,9,8,20,5,0,42,12
1860,3536,35,2012/2013,2013-04-27 00:00:00,Southampton,West Bromwich Albion,0,3,1.85,3.75,4.6,4,6,13,3,9,11,2,2,2,1,31,22,7,6,55.0,45.0,3,10,16,20,4,3,53,13
1861,3537,35,2012/2013,2013-04-27 00:00:00,Stoke City,Norwich City,1,0,2.25,3.3,3.6,5,1,8,5,11,8,4,2,0,0,15,23,6,3,47.0,53.0,1,6,13,19,6,0,38,9
1862,3538,35,2012/2013,2013-04-27 00:00:00,Wigan Athletic,Tottenham Hotspur,2,2,3.8,3.6,2.05,2,6,2,9,14,11,3,1,0,0,15,15,3,3,53.0,47.0,4,8,11,25,4,0,30,6
1863,3529,35,2012/2013,2013-04-28 00:00:00,Arsenal,Manchester United,1,1,2.25,3.6,3.3,9,5,8,6,11,12,3,5,0,0,20,13,7,2,45.0,55.0,2,14,14,23,8,0,33,9
1864,3531,35,2012/2013,2013-04-28 00:00:00,Chelsea,Swansea City,2,0,1.36,5.5,9.0,17,6,6,4,7,11,1,3,0,0,17,12,5,3,60.0,40.0,2,23,10,18,4,0,29,8
1865,3535,35,2012/2013,2013-04-28 00:00:00,Reading,Queens Park Rangers,0,0,2.55,3.5,2.88,6,5,6,12,13,13,0,2,0,0,33,23,9,7,54.0,46.0,0,11,18,26,2,0,56,16
1866,3530,35,2012/2013,2013-04-29 00:00:00,Aston Villa,Sunderland,6,1,2.3,3.4,3.4,6,5,2,3,10,13,0,3,0,1,24,15,4,5,61.0,39.0,7,11,5,23,3,1,39,9
1867,3539,36,2012/2013,2013-05-04 00:00:00,Fulham,Reading,2,4,1.73,3.9,5.25,11,10,7,7,10,8,2,1,0,0,26,14,3,3,49.0,51.0,6,21,14,18,3,0,40,6
1868,3542,36,2012/2013,2013-05-04 00:00:00,Norwich City,Aston Villa,1,2,2.55,3.3,3.0,5,5,7,8,15,13,2,3,0,0,29,16,6,5,57.0,43.0,3,10,15,28,5,0,45,11
1869,3543,36,2012/2013,2013-05-04 00:00:00,Queens Park Rangers,Arsenal,0,1,8.0,4.75,1.44,7,9,6,1,7,8,2,1,0,0,23,16,3,7,41.0,59.0,1,16,7,15,3,0,39,10
1870,3545,36,2012/2013,2013-05-04 00:00:00,Swansea City,Manchester City,0,0,5.25,3.8,1.75,1,7,6,5,8,9,0,0,0,0,14,18,4,4,52.0,48.0,0,8,11,17,0,0,32,8
1871,3546,36,2012/2013,2013-05-04 00:00:00,Tottenham Hotspur,Southampton,1,0,1.44,4.75,8.0,2,2,4,6,10,11,1,1,0,0,26,15,5,5,61.0,39.0,1,4,10,21,2,0,41,10
1872,3547,36,2012/2013,2013-05-04 00:00:00,West Bromwich Albion,Wigan Athletic,2,3,2.45,3.5,3.0,10,5,5,6,10,10,4,3,0,0,20,19,7,5,47.0,53.0,5,15,11,20,7,0,39,12
1873,3548,36,2012/2013,2013-05-04 00:00:00,West Ham United,Newcastle United,0,0,2.38,3.4,3.25,6,6,5,5,12,13,1,2,0,0,23,13,7,3,50.0,50.0,0,12,10,25,3,0,36,10
1874,3540,36,2012/2013,2013-05-05 00:00:00,Liverpool,Everton,0,0,1.95,3.6,4.2,7,2,9,8,10,11,1,2,0,0,19,19,3,5,51.0,49.0,0,9,17,21,3,0,38,8
1875,3541,36,2012/2013,2013-05-05 00:00:00,Manchester United,Chelsea,0,1,2.2,3.5,3.5,3,6,7,9,13,10,2,1,1,0,20,22,2,7,48.0,52.0,1,9,16,23,3,1,42,9
1876,3544,36,2012/2013,2013-05-06 00:00:00,Sunderland,Stoke City,1,1,2.1,3.3,4.0,5,6,9,4,7,12,2,2,1,0,23,16,5,6,59.0,41.0,2,11,13,19,4,1,39,11
1877,3513,33,2012/2013,2013-05-07 00:00:00,Manchester City,West Bromwich Albion,1,0,1.4,5.0,9.0,10,10,8,8,8,5,2,1,0,0,15,21,6,8,54.0,46.0,1,20,16,13,3,0,36,14
1878,3518,33,2012/2013,2013-05-07 00:00:00,Wigan Athletic,Swansea City,2,3,1.83,3.75,4.75,8,5,6,3,16,13,2,2,0,0,26,8,4,4,56.0,44.0,5,13,9,29,4,0,34,8
1879,3511,33,2012/2013,2013-05-08 00:00:00,Chelsea,Tottenham Hotspur,2,2,1.95,3.75,4.0,6,5,8,7,8,17,1,2,0,0,26,18,6,5,52.0,48.0,4,11,15,25,3,0,44,11
1880,3550,37,2012/2013,2013-05-11 00:00:00,Aston Villa,Chelsea,1,2,4.5,3.8,1.85,7,9,7,3,13,8,2,3,0,0,31,26,6,7,44.0,56.0,3,16,10,21,5,0,57,13
1881,3551,37,2012/2013,2013-05-12 00:00:00,Everton,West Ham United,2,0,1.5,4.5,7.5,11,2,11,4,3,10,1,2,0,0,25,13,7,1,60.0,40.0,2,13,15,13,3,0,38,8
1882,3552,37,2012/2013,2013-05-12 00:00:00,Fulham,Liverpool,1,3,3.9,3.6,2.05,6,8,2,6,2,9,0,1,0,0,18,20,7,8,45.0,55.0,4,14,8,11,1,0,38,15
1883,3553,37,2012/2013,2013-05-12 00:00:00,Manchester United,Swansea City,2,1,1.3,5.75,12.0,5,3,9,5,5,8,0,0,0,0,24,14,7,5,55.0,45.0,3,8,14,13,0,0,38,12
1884,3554,37,2012/2013,2013-05-12 00:00:00,Norwich City,West Bromwich Albion,4,0,2.2,3.4,3.6,5,6,3,2,8,9,2,1,0,0,32,19,8,2,48.0,52.0,4,11,5,17,3,0,51,10
1885,3555,37,2012/2013,2013-05-12 00:00:00,Queens Park Rangers,Newcastle United,1,2,3.4,3.4,2.3,3,5,5,5,10,9,1,3,0,0,11,7,2,2,47.0,53.0,3,8,10,19,4,0,18,4
1886,3557,37,2012/2013,2013-05-12 00:00:00,Stoke City,Tottenham Hotspur,1,2,4.5,3.6,1.91,1,11,4,9,13,6,4,1,0,0,24,22,2,11,50.0,50.0,3,12,13,19,5,0,46,13
1887,3558,37,2012/2013,2013-05-12 00:00:00,Sunderland,Southampton,1,1,2.8,3.2,2.8,4,10,2,7,9,12,0,2,0,0,23,33,3,10,41.0,59.0,2,14,9,21,2,0,56,13
1888,3549,37,2012/2013,2013-05-14 00:00:00,Arsenal,Wigan Athletic,4,1,1.4,5.5,8.0,8,5,8,5,11,11,0,2,0,0,27,16,7,4,51.0,49.0,5,13,13,22,2,0,43,11
1889,3556,37,2012/2013,2013-05-14 00:00:00,Reading,Manchester City,0,2,6.0,4.33,1.6,8,19,3,6,7,7,0,1,0,0,13,24,4,10,38.0,62.0,2,27,9,14,1,0,37,14
1890,3559,38,2012/2013,2013-05-19 00:00:00,Chelsea,Everton,2,1,1.7,4.0,5.5,11,8,11,6,5,5,2,2,0,0,17,13,7,4,47.0,53.0,3,19,17,10,4,0,30,11
1891,3560,38,2012/2013,2013-05-19 00:00:00,Liverpool,Queens Park Rangers,1,0,1.25,7.0,12.0,19,4,10,8,7,3,1,3,0,0,32,6,14,0,61.0,39.0,1,23,18,10,4,0,38,14
1892,3561,38,2012/2013,2013-05-19 00:00:00,Manchester City,Norwich City,2,3,1.33,5.5,11.0,3,6,7,6,9,9,1,0,0,0,28,18,7,7,49.0,51.0,5,9,13,18,1,0,46,14
1893,3562,38,2012/2013,2013-05-19 00:00:00,Newcastle United,Arsenal,0,1,6.0,4.6,1.55,3,3,4,8,17,9,1,2,0,0,24,31,4,4,48.0,52.0,1,6,12,26,3,0,55,8
1894,3563,38,2012/2013,2013-05-19 00:00:00,Southampton,Stoke City,1,1,1.75,3.8,5.25,7,2,4,4,10,7,0,2,0,0,26,22,3,4,55.0,45.0,2,9,8,17,2,0,48,7
1895,3564,38,2012/2013,2013-05-19 00:00:00,Swansea City,Fulham,0,3,1.8,3.8,4.75,13,1,9,4,11,8,2,1,0,0,25,4,8,0,66.0,34.0,3,14,13,19,3,0,29,8
1896,3565,38,2012/2013,2013-05-19 00:00:00,Tottenham Hotspur,Sunderland,1,0,1.29,6.0,12.0,21,5,10,2,6,12,1,3,0,0,39,10,14,1,65.0,35.0,1,26,12,18,4,0,49,15
1897,3566,38,2012/2013,2013-05-19 00:00:00,West Bromwich Albion,Manchester United,5,5,4.5,3.9,1.83,4,5,9,7,9,8,0,1,0,0,18,27,3,5,42.0,58.0,10,9,16,17,1,0,45,8
1898,3567,38,2012/2013,2013-05-19 00:00:00,West Ham United,Reading,4,2,1.67,4.0,5.75,6,4,11,11,13,10,1,1,0,0,18,13,6,4,54.0,46.0,6,10,22,23,2,0,31,10
1899,3568,38,2012/2013,2013-05-19 00:00:00,Wigan Athletic,Aston Villa,2,2,2.15,3.6,3.6,8,4,7,5,10,14,2,1,0,0,17,15,4,2,53.0,47.0,4,12,12,24,3,0,32,6
1900,3629,1,2013/2014,2013-08-17 00:00:00,Arsenal,Aston Villa,1,3,1.44,4.75,8.0,9,3,6,3,15,18,4,5,0,0,22,10,4,3,54.0,46.0,4,12,9,33,9,0,32,7
1901,3632,1,2013/2014,2013-08-17 00:00:00,Liverpool,Stoke City,1,0,1.4,5.0,9.5,14,6,10,2,10,10,1,1,0,0,27,20,12,6,52.0,48.0,1,20,12,20,2,0,47,18
1902,3634,1,2013/2014,2013-08-17 00:00:00,Norwich City,Everton,2,2,3.2,3.4,2.4,3,6,2,10,13,9,2,0,0,0,19,29,6,8,32.0,68.0,4,9,12,22,2,0,48,14
1903,3635,1,2013/2014,2013-08-17 00:00:00,Sunderland,Fulham,0,1,2.3,3.4,3.4,8,4,13,0,15,14,0,3,0,0,32,8,6,1,52.0,48.0,1,12,13,29,3,0,40,7
1904,3636,1,2013/2014,2013-08-17 00:00:00,Swansea City,Manchester United,1,4,4.2,3.5,2.0,6,4,9,3,13,10,1,3,0,0,40,12,7,4,52.0,48.0,5,10,12,23,4,0,52,11
1905,3637,1,2013/2014,2013-08-17 00:00:00,West Bromwich Albion,Southampton,0,1,2.4,3.4,3.2,7,5,5,2,15,23,4,0,0,0,31,35,4,8,47.0,53.0,1,12,7,38,4,0,66,12
1906,3638,1,2013/2014,2013-08-17 00:00:00,West Ham United,Cardiff City,2,0,2.0,3.6,4.0,6,4,9,6,10,7,0,1,0,0,21,20,4,3,48.0,52.0,2,10,15,17,1,0,41,7
1907,3630,1,2013/2014,2013-08-18 00:00:00,Chelsea,Hull City,2,0,1.2,7.0,21.0,7,6,13,1,7,17,0,1,0,0,12,25,5,1,52.0,48.0,2,13,14,24,1,0,37,6
1908,3631,1,2013/2014,2013-08-18 00:00:00,Crystal Palace,Tottenham Hotspur,0,1,4.75,3.75,1.83,4,6,2,11,10,8,1,0,0,0,17,18,3,7,46.0,54.0,1,10,13,18,1,0,35,10
1909,3633,1,2013/2014,2013-08-19 00:00:00,Manchester City,Newcastle United,4,0,1.33,5.5,11.0,11,2,6,3,8,10,2,3,0,1,24,8,8,1,62.0,38.0,4,13,9,18,5,1,32,9
1910,3851,3,2013/2014,2013-08-21 00:00:00,Chelsea,Aston Villa,2,1,1.29,5.5,10.0,5,3,8,2,13,14,1,4,0,0,10,11,1,2,70.0,30.0,3,8,10,27,5,0,21,3
1911,3739,2,2013/2014,2013-08-24 00:00:00,Aston Villa,Liverpool,0,1,4.0,3.75,1.95,7,1,10,2,8,10,3,3,0,0,25,12,8,2,47.0,53.0,1,8,12,18,6,0,37,10
1912,3741,2,2013/2014,2013-08-24 00:00:00,Everton,West Bromwich Albion,0,0,1.57,4.33,6.5,16,3,8,4,16,14,1,1,0,0,37,13,11,1,55.0,45.0,0,19,12,30,2,0,50,12
1913,3742,2,2013/2014,2013-08-24 00:00:00,Fulham,Arsenal,1,3,3.8,3.5,2.1,7,8,7,6,12,7,2,2,0,0,27,23,1,8,49.0,51.0,4,15,13,19,4,0,50,9
1914,3743,2,2013/2014,2013-08-24 00:00:00,Hull City,Norwich City,1,0,2.45,3.4,3.1,1,6,5,8,16,18,1,1,1,0,15,24,1,5,41.0,59.0,1,7,13,34,2,1,39,6
1915,3745,2,2013/2014,2013-08-24 00:00:00,Newcastle United,West Ham United,0,0,2.3,3.4,3.4,3,3,15,5,12,14,0,1,0,0,29,27,5,4,55.0,45.0,0,6,20,26,1,0,56,9
1916,3746,2,2013/2014,2013-08-24 00:00:00,Southampton,Sunderland,1,1,1.73,3.8,5.5,9,3,8,3,11,12,2,2,0,0,30,14,5,2,56.0,44.0,2,12,11,23,4,0,44,7
1917,3747,2,2013/2014,2013-08-24 00:00:00,Stoke City,Crystal Palace,2,1,1.83,3.6,5.0,5,5,6,6,12,5,3,0,0,0,31,12,7,0,51.0,49.0,3,10,12,17,3,0,43,7
1918,3740,2,2013/2014,2013-08-25 00:00:00,Cardiff City,Manchester City,3,2,8.5,4.75,1.44,4,5,2,7,2,11,0,0,0,0,12,36,3,8,31.0,69.0,5,9,9,13,0,0,48,11
1919,3748,2,2013/2014,2013-08-25 00:00:00,Tottenham Hotspur,Swansea City,1,0,1.62,4.0,6.5,9,5,8,3,11,13,1,4,0,0,25,9,8,3,49.0,51.0,1,14,11,24,5,0,34,11
1920,3744,2,2013/2014,2013-08-26 00:00:00,Manchester United,Chelsea,0,0,2.45,3.4,3.1,7,6,6,3,8,9,0,2,0,0,24,14,4,1,57.0,43.0,0,13,9,17,2,0,38,5
1921,3850,3,2013/2014,2013-08-31 00:00:00,Cardiff City,Everton,0,0,3.25,3.4,2.38,1,7,2,6,10,7,1,1,0,0,7,18,4,5,39.0,61.0,0,8,8,17,2,0,25,9
1922,3852,3,2013/2014,2013-08-31 00:00:00,Crystal Palace,Sunderland,3,1,2.6,3.3,3.0,6,7,10,2,7,7,1,0,0,1,20,25,6,6,49.0,51.0,4,13,12,14,1,1,45,12
1923,3854,3,2013/2014,2013-08-31 00:00:00,Manchester City,Hull City,2,0,1.17,8.5,19.0,5,1,4,4,14,10,2,3,0,0,21,14,7,4,59.0,41.0,2,6,8,24,5,0,35,11
1924,3855,3,2013/2014,2013-08-31 00:00:00,Newcastle United,Fulham,1,0,2.15,3.4,3.75,13,2,6,1,7,5,2,2,0,0,32,7,13,2,54.0,46.0,1,15,7,12,4,0,39,15
1925,3856,3,2013/2014,2013-08-31 00:00:00,Norwich City,Southampton,1,0,3.0,3.3,2.55,9,4,7,7,10,14,0,0,0,0,17,21,5,4,41.0,59.0,1,13,14,24,0,0,38,9
1926,3858,3,2013/2014,2013-08-31 00:00:00,West Ham United,Stoke City,0,1,2.0,3.4,4.33,3,5,8,8,10,12,2,1,0,0,23,23,3,4,46.0,54.0,1,8,16,22,3,0,46,7
1927,3849,3,2013/2014,2013-09-01 00:00:00,Arsenal,Tottenham Hotspur,1,0,2.1,3.7,3.6,6,8,6,8,14,14,2,2,0,0,10,22,3,6,44.0,56.0,1,14,14,28,4,0,32,9
1928,3853,3,2013/2014,2013-09-01 00:00:00,Liverpool,Manchester United,1,0,2.63,3.4,2.88,6,8,4,5,15,15,2,4,0,0,5,32,2,7,43.0,57.0,1,14,9,30,6,0,37,9
1929,3857,3,2013/2014,2013-09-01 00:00:00,West Bromwich Albion,Swansea City,0,2,2.7,3.4,2.8,5,7,4,4,8,15,4,3,0,0,21,20,2,5,43.0,57.0,2,12,8,23,7,0,41,7
1930,3949,4,2013/2014,2013-09-14 00:00:00,Aston Villa,Newcastle United,1,2,2.15,3.4,3.8,3,8,6,6,11,10,1,4,0,0,21,17,4,2,55.0,45.0,3,11,12,21,5,0,38,6
1931,3950,4,2013/2014,2013-09-14 00:00:00,Everton,Chelsea,1,0,3.4,3.3,2.35,4,8,5,13,8,13,0,4,0,0,18,29,5,7,44.0,56.0,1,12,18,21,4,0,47,12
1932,3951,4,2013/2014,2013-09-14 00:00:00,Fulham,West Bromwich Albion,1,1,2.15,3.5,3.6,2,5,9,5,9,10,0,1,0,0,24,22,4,5,55.0,45.0,2,7,14,19,1,0,46,9
1933,3952,4,2013/2014,2013-09-14 00:00:00,Hull City,Cardiff City,1,1,2.45,3.25,3.25,8,4,7,5,7,8,1,2,0,0,20,8,6,2,44.0,56.0,2,12,12,15,3,0,28,8
1934,3953,4,2013/2014,2013-09-14 00:00:00,Manchester United,Crystal Palace,2,0,1.22,7.0,16.0,10,0,9,4,9,13,1,2,0,1,42,1,10,1,60.0,40.0,2,10,13,22,3,1,43,11
1935,3955,4,2013/2014,2013-09-14 00:00:00,Stoke City,Manchester City,0,0,6.0,4.0,1.65,5,3,7,8,12,11,1,1,0,0,16,20,2,4,44.0,56.0,0,8,15,23,2,0,36,6
1936,3956,4,2013/2014,2013-09-14 00:00:00,Sunderland,Arsenal,1,3,6.0,3.9,1.67,6,9,9,2,10,8,1,2,0,0,17,27,6,7,30.0,70.0,4,15,11,18,3,0,44,13
1937,3958,4,2013/2014,2013-09-14 00:00:00,Tottenham Hotspur,Norwich City,2,0,1.45,4.75,8.0,6,4,12,1,4,12,1,3,0,0,24,6,8,1,68.0,32.0,2,10,13,16,4,0,30,9
1938,3954,4,2013/2014,2013-09-15 00:00:00,Southampton,West Ham United,0,0,1.85,3.6,4.75,10,3,5,4,12,11,1,3,0,0,28,24,10,5,59.0,41.0,0,13,9,23,4,0,52,15
1939,3957,4,2013/2014,2013-09-16 00:00:00,Swansea City,Liverpool,2,2,3.5,3.5,2.2,9,5,7,4,7,7,2,3,0,0,33,22,3,7,56.0,44.0,4,14,11,14,5,0,55,10
1940,3961,5,2013/2014,2013-09-21 00:00:00,Chelsea,Fulham,2,0,1.3,5.75,12.0,12,2,12,3,10,9,0,0,0,0,40,12,13,3,65.0,35.0,2,14,15,19,0,0,52,16
1941,3963,5,2013/2014,2013-09-21 00:00:00,Liverpool,Southampton,0,1,1.6,4.0,6.5,8,8,4,3,6,10,0,1,0,0,23,19,6,6,57.0,43.0,1,16,7,16,1,0,42,12
1942,3965,5,2013/2014,2013-09-21 00:00:00,Newcastle United,Hull City,2,3,1.85,3.5,5.0,5,7,7,1,11,8,1,1,0,0,21,11,3,3,60.0,40.0,5,12,8,19,2,0,32,6
1943,3966,5,2013/2014,2013-09-21 00:00:00,Norwich City,Aston Villa,0,1,2.4,3.4,3.2,3,3,9,11,16,12,1,0,0,0,37,14,7,4,64.0,36.0,1,6,20,28,1,0,51,11
1944,3967,5,2013/2014,2013-09-21 00:00:00,West Bromwich Albion,Sunderland,3,0,2.05,3.4,4.2,3,4,6,3,9,12,0,2,0,0,23,31,5,6,52.0,48.0,3,7,9,21,2,0,54,11
1945,3968,5,2013/2014,2013-09-21 00:00:00,West Ham United,Everton,2,3,3.3,3.3,2.4,2,3,6,6,18,12,3,1,0,0,19,18,5,5,38.0,62.0,5,5,12,30,4,0,37,10
1946,3959,5,2013/2014,2013-09-22 00:00:00,Arsenal,Stoke City,3,1,1.36,5.25,10.0,9,4,3,2,8,15,0,2,0,0,12,24,6,7,49.0,51.0,4,13,5,23,2,0,36,13
1947,3960,5,2013/2014,2013-09-22 00:00:00,Cardiff City,Tottenham Hotspur,0,1,4.5,3.6,1.91,0,15,5,9,6,6,1,4,0,0,14,29,2,12,38.0,62.0,1,15,14,12,5,0,43,14
1948,3962,5,2013/2014,2013-09-22 00:00:00,Crystal Palace,Swansea City,0,2,3.5,3.4,2.25,5,5,5,5,8,8,2,2,0,0,19,21,6,8,44.0,56.0,2,10,10,16,4,0,40,14
1949,3964,5,2013/2014,2013-09-22 00:00:00,Manchester City,Manchester United,4,1,2.2,3.4,3.6,3,3,8,7,10,13,1,2,0,0,19,24,8,4,42.0,58.0,5,6,15,23,3,0,43,12
1950,3969,6,2013/2014,2013-09-28 00:00:00,Aston Villa,Manchester City,3,2,6.5,4.2,1.57,1,9,3,10,11,9,1,1,0,0,6,32,2,13,34.0,66.0,5,10,13,20,2,0,38,15
1951,3971,6,2013/2014,2013-09-28 00:00:00,Fulham,Cardiff City,1,2,2.1,3.4,3.9,4,6,3,11,13,13,1,1,0,0,27,26,9,10,47.0,53.0,3,10,14,26,2,0,53,19
1952,3972,6,2013/2014,2013-09-28 00:00:00,Hull City,West Ham United,1,0,2.38,3.3,3.3,5,7,4,8,11,13,1,2,0,0,19,42,6,6,48.0,52.0,1,12,12,24,3,0,61,12
1953,3973,6,2013/2014,2013-09-28 00:00:00,Manchester United,West Bromwich Albion,1,2,1.3,5.75,12.0,10,2,4,8,10,14,3,2,0,0,32,24,5,8,59.0,41.0,3,12,12,24,5,0,56,13
1954,3974,6,2013/2014,2013-09-28 00:00:00,Southampton,Crystal Palace,2,0,1.45,4.5,8.5,4,3,5,2,11,13,1,2,0,0,24,12,6,2,62.0,38.0,2,7,7,24,3,0,36,8
1955,3977,6,2013/2014,2013-09-28 00:00:00,Swansea City,Arsenal,1,2,3.2,3.4,2.38,3,3,5,4,6,10,3,2,0,0,14,11,4,3,57.0,43.0,3,6,9,16,5,0,25,7
1956,3978,6,2013/2014,2013-09-28 00:00:00,Tottenham Hotspur,Chelsea,1,1,2.7,3.3,2.88,3,7,8,4,16,14,5,2,0,0,15,24,4,5,53.0,47.0,2,10,12,30,7,0,39,9
1957,3975,6,2013/2014,2013-09-29 00:00:00,Stoke City,Norwich City,0,1,1.95,3.4,4.5,3,4,4,3,13,11,2,1,0,0,28,14,7,3,57.0,43.0,1,7,7,24,3,0,42,10
1958,3976,6,2013/2014,2013-09-29 00:00:00,Sunderland,Liverpool,1,3,5.5,3.9,1.7,10,7,10,6,8,9,2,1,0,0,35,29,10,8,47.0,53.0,4,17,16,17,3,0,64,18
1959,3970,6,2013/2014,2013-09-30 00:00:00,Everton,Newcastle United,3,2,1.65,4.0,6.0,8,9,7,5,8,14,3,1,0,0,8,15,1,1,50.0,50.0,5,17,12,22,4,0,23,2
1960,3979,7,2013/2014,2013-10-05 00:00:00,Cardiff City,Newcastle United,1,2,2.45,3.4,3.1,3,11,6,5,11,8,1,0,0,0,16,12,3,3,57.0,43.0,3,14,11,19,1,0,28,6
1961,3980,7,2013/2014,2013-10-05 00:00:00,Fulham,Stoke City,1,0,2.4,3.3,3.3,4,7,3,8,9,12,3,2,0,0,20,17,7,5,44.0,56.0,1,11,11,21,5,0,37,12
1962,3981,7,2013/2014,2013-10-05 00:00:00,Hull City,Aston Villa,0,0,2.45,3.3,3.2,2,8,8,8,7,11,2,1,0,0,31,18,7,7,45.0,55.0,0,10,16,18,3,0,49,14
1963,3982,7,2013/2014,2013-10-05 00:00:00,Liverpool,Crystal Palace,3,1,1.2,7.5,17.0,5,6,4,5,12,5,2,1,0,0,29,17,10,3,63.0,37.0,4,11,9,17,3,0,46,13
1964,3983,7,2013/2014,2013-10-05 00:00:00,Manchester City,Everton,3,1,1.67,4.2,5.5,6,4,9,1,13,10,5,4,0,0,21,11,8,1,54.0,46.0,4,10,10,23,9,0,32,9
1965,3986,7,2013/2014,2013-10-05 00:00:00,Sunderland,Manchester United,1,2,6.0,4.0,1.65,4,5,1,6,15,12,2,4,0,0,17,34,4,4,37.0,63.0,3,9,7,27,6,0,51,8
1966,3984,7,2013/2014,2013-10-06 00:00:00,Norwich City,Chelsea,1,3,6.5,4.0,1.62,7,12,9,8,11,7,1,1,0,0,22,19,4,6,45.0,55.0,4,19,17,18,2,0,41,10
1967,3985,7,2013/2014,2013-10-06 00:00:00,Southampton,Swansea City,2,0,2.1,3.5,3.8,5,9,6,7,12,6,3,1,0,0,22,33,7,4,42.0,58.0,2,14,13,18,4,0,55,11
1968,3987,7,2013/2014,2013-10-06 00:00:00,Tottenham Hotspur,West Ham United,0,3,1.44,4.75,8.5,7,5,9,8,5,9,0,0,0,0,25,21,6,6,61.0,39.0,3,12,17,14,0,0,46,12
1969,3988,7,2013/2014,2013-10-06 00:00:00,West Bromwich Albion,Arsenal,1,1,4.9,4.0,1.75,4,4,5,8,7,11,1,2,0,0,30,23,6,2,44.0,56.0,2,8,13,18,3,0,53,8
1970,3989,8,2013/2014,2013-10-19 00:00:00,Arsenal,Norwich City,4,1,1.29,6.0,12.0,8,6,7,4,9,6,0,0,0,0,28,12,10,1,56.0,44.0,5,14,11,15,0,0,40,11
1971,3991,8,2013/2014,2013-10-19 00:00:00,Chelsea,Cardiff City,4,1,1.25,6.5,15.0,9,6,10,5,13,5,1,2,0,0,24,19,6,8,66.0,34.0,5,15,15,18,3,0,43,14
1972,3993,8,2013/2014,2013-10-19 00:00:00,Everton,Hull City,2,1,1.45,4.5,9.0,7,2,4,7,8,16,3,1,0,0,20,21,5,7,67.0,33.0,3,9,11,24,4,0,41,12
1973,3994,8,2013/2014,2013-10-19 00:00:00,Manchester United,Southampton,1,1,1.57,4.33,6.5,6,9,5,8,10,17,2,3,0,0,21,22,4,4,47.0,53.0,2,15,13,27,5,0,43,8
1974,3995,8,2013/2014,2013-10-19 00:00:00,Newcastle United,Liverpool,2,2,4.5,3.9,1.83,4,6,5,11,8,9,2,3,1,0,15,26,3,13,37.0,63.0,4,10,16,17,5,1,41,16
1975,3996,8,2013/2014,2013-10-19 00:00:00,Stoke City,West Bromwich Albion,0,0,2.3,3.3,3.5,4,6,6,2,11,7,1,0,0,0,23,18,6,6,51.0,49.0,0,10,8,18,1,0,41,12
1976,3997,8,2013/2014,2013-10-19 00:00:00,Swansea City,Sunderland,4,0,1.62,4.0,6.5,8,3,3,3,12,12,1,2,0,0,27,11,7,2,63.0,37.0,4,11,6,24,3,0,38,9
1977,3998,8,2013/2014,2013-10-19 00:00:00,West Ham United,Manchester City,1,3,5.5,3.8,1.73,0,11,6,3,8,10,1,2,0,0,29,13,5,5,37.0,63.0,4,11,9,18,3,0,42,10
1978,3990,8,2013/2014,2013-10-20 00:00:00,Aston Villa,Tottenham Hotspur,0,2,4.0,3.5,2.05,7,7,12,7,12,12,3,4,0,0,21,21,4,7,38.0,62.0,2,14,19,24,7,0,42,11
1979,3992,8,2013/2014,2013-10-21 00:00:00,Crystal Palace,Fulham,1,4,2.75,3.3,2.8,5,2,5,2,6,12,0,1,0,0,25,11,5,7,45.0,55.0,5,7,7,18,1,0,36,12
1980,3999,9,2013/2014,2013-10-26 00:00:00,Aston Villa,Everton,0,2,3.4,3.4,2.3,9,10,5,4,8,6,0,2,0,0,22,15,8,6,47.0,53.0,2,19,9,14,2,0,37,14
1981,4001,9,2013/2014,2013-10-26 00:00:00,Crystal Palace,Arsenal,0,2,11.0,5.0,1.36,6,4,7,4,12,8,0,0,0,1,18,19,4,3,37.0,63.0,2,10,11,20,0,1,37,7
1982,4002,9,2013/2014,2013-10-26 00:00:00,Liverpool,West Bromwich Albion,4,1,1.44,4.75,8.0,3,4,12,5,13,11,0,2,0,0,18,21,3,8,54.0,46.0,5,7,17,24,2,0,39,11
1983,4003,9,2013/2014,2013-10-26 00:00:00,Manchester United,Stoke City,3,2,1.33,5.5,11.0,5,6,12,2,8,20,2,6,0,0,40,16,12,2,66.0,34.0,5,11,14,28,8,0,56,14
1984,4004,9,2013/2014,2013-10-26 00:00:00,Norwich City,Cardiff City,0,0,2.2,3.4,3.6,17,7,12,2,8,9,1,1,0,0,44,14,13,2,61.0,39.0,0,24,14,17,2,0,58,15
1985,4005,9,2013/2014,2013-10-26 00:00:00,Southampton,Fulham,2,0,1.62,4.0,6.5,6,0,11,1,12,9,0,2,0,0,34,11,10,3,66.0,34.0,2,6,12,21,2,0,45,13
1986,4000,9,2013/2014,2013-10-27 00:00:00,Chelsea,Manchester City,2,1,2.38,3.4,3.2,3,9,9,5,12,15,2,3,0,0,24,15,3,6,46.0,54.0,3,12,14,27,5,0,39,9
1987,4006,9,2013/2014,2013-10-27 00:00:00,Sunderland,Newcastle United,2,1,2.9,3.3,2.63,5,7,2,7,11,14,1,1,0,0,19,14,5,3,48.0,52.0,3,12,9,25,2,0,33,8
1988,4007,9,2013/2014,2013-10-27 00:00:00,Tottenham Hotspur,Hull City,1,0,1.44,4.75,8.0,7,7,7,3,10,9,3,3,0,0,19,16,6,4,67.0,33.0,1,14,10,19,6,0,35,10
1989,4008,9,2013/2014,2013-10-27 00:00:00,Swansea City,West Ham United,0,0,1.75,3.8,5.25,8,7,3,8,12,11,1,3,0,0,21,22,9,6,67.0,33.0,0,15,11,23,4,0,43,15
1990,3639,10,2013/2014,2013-11-02 00:00:00,Arsenal,Liverpool,2,0,2.3,3.5,3.3,7,7,3,5,9,7,2,1,0,0,18,25,3,5,,,2,14,8,16,3,0,43,8
1991,3642,10,2013/2014,2013-11-02 00:00:00,Fulham,Manchester United,1,3,6.5,4.2,1.57,6,1,6,4,7,10,2,1,0,0,19,17,4,4,48.0,52.0,4,7,10,17,3,0,36,8
1992,3643,10,2013/2014,2013-11-02 00:00:00,Hull City,Sunderland,1,0,2.15,3.4,3.8,8,2,12,6,16,11,2,0,0,2,28,4,4,2,70.0,30.0,1,10,18,27,2,2,32,6
1993,3644,10,2013/2014,2013-11-02 00:00:00,Manchester City,Norwich City,7,0,1.2,7.5,18.0,13,4,7,2,5,8,1,1,0,0,24,6,10,3,69.0,31.0,7,17,9,13,2,0,30,13
1994,3645,10,2013/2014,2013-11-02 00:00:00,Newcastle United,Chelsea,2,0,6.0,4.2,1.62,10,9,4,6,11,10,2,2,0,0,15,28,3,8,40.0,60.0,2,19,10,21,4,0,43,11
1995,3646,10,2013/2014,2013-11-02 00:00:00,Stoke City,Southampton,1,1,3.3,3.3,2.4,4,3,5,7,12,12,3,1,0,0,13,25,5,5,39.0,61.0,2,7,12,24,4,0,38,10
1996,3647,10,2013/2014,2013-11-02 00:00:00,West Bromwich Albion,Crystal Palace,2,0,1.55,4.2,7.0,3,6,2,6,10,8,0,1,0,0,30,13,10,3,51.0,49.0,2,9,8,18,1,0,43,13
1997,3648,10,2013/2014,2013-11-02 00:00:00,West Ham United,Aston Villa,0,0,2.25,3.5,3.4,4,3,5,2,1,8,0,2,0,0,22,5,5,1,58.0,42.0,0,7,7,9,2,0,27,6
1998,3640,10,2013/2014,2013-11-03 00:00:00,Cardiff City,Swansea City,1,0,3.4,3.4,2.3,6,5,2,5,10,6,1,1,0,1,13,19,6,3,45.0,55.0,1,11,7,16,2,1,32,9
1999,3641,10,2013/2014,2013-11-03 00:00:00,Everton,Tottenham Hotspur,0,0,2.5,3.4,3.0,6,12,6,4,9,8,4,1,0,0,24,19,7,4,52.0,48.0,0,18,10,17,5,0,43,11
2000,3649,11,2013/2014,2013-11-09 00:00:00,Aston Villa,Cardiff City,2,0,2.0,3.5,4.2,8,3,7,3,9,4,1,1,0,0,20,15,5,3,44.0,56.0,2,11,10,13,2,0,35,8
2001,3650,11,2013/2014,2013-11-09 00:00:00,Chelsea,West Bromwich Albion,2,2,1.29,6.0,12.0,10,3,5,6,10,18,3,7,0,0,47,17,9,4,68.0,32.0,4,13,11,28,10,0,64,13
2002,3651,11,2013/2014,2013-11-09 00:00:00,Crystal Palace,Everton,0,0,6.5,4.0,1.62,3,4,6,8,16,8,1,0,0,0,17,27,4,7,28.0,72.0,0,7,14,24,1,0,44,11
2003,3652,11,2013/2014,2013-11-09 00:00:00,Liverpool,Fulham,4,0,1.25,6.5,15.0,14,1,12,2,13,8,0,1,0,0,28,13,9,3,69.0,31.0,4,15,14,21,1,0,41,12
2004,3654,11,2013/2014,2013-11-09 00:00:00,Norwich City,West Ham United,3,1,2.63,3.3,2.9,2,8,8,3,12,11,1,1,0,0,18,25,4,2,47.0,53.0,4,10,11,23,2,0,43,6
2005,3655,11,2013/2014,2013-11-09 00:00:00,Southampton,Hull City,4,1,1.62,3.8,7.0,4,3,5,6,9,14,1,2,0,0,18,17,6,5,60.0,40.0,5,7,11,23,3,0,35,11
2006,3653,11,2013/2014,2013-11-10 00:00:00,Manchester United,Arsenal,1,0,2.35,3.5,3.2,1,5,3,5,13,12,2,3,0,0,28,29,5,6,41.0,59.0,1,6,8,25,5,0,57,11
2007,3656,11,2013/2014,2013-11-10 00:00:00,Sunderland,Manchester City,1,0,9.0,5.0,1.4,2,10,3,11,6,13,0,1,0,0,10,47,0,13,40.0,60.0,1,12,14,19,1,0,57,13
2008,3657,11,2013/2014,2013-11-10 00:00:00,Swansea City,Stoke City,3,3,2.0,3.4,4.33,12,1,3,1,12,15,5,3,0,0,36,7,14,3,65.0,35.0,6,13,4,27,8,0,43,17
2009,3658,11,2013/2014,2013-11-10 00:00:00,Tottenham Hotspur,Newcastle United,0,1,1.57,4.33,6.5,19,5,10,2,5,14,1,2,0,0,33,9,11,4,66.0,34.0,1,24,12,19,3,0,42,15
2010,3659,12,2013/2014,2013-11-23 00:00:00,Arsenal,Southampton,2,0,1.62,4.2,6.0,2,6,3,2,10,15,0,3,0,0,19,15,5,6,48.0,52.0,2,8,5,25,3,0,34,11
2011,3661,12,2013/2014,2013-11-23 00:00:00,Everton,Liverpool,3,3,3.0,3.4,2.5,8,4,6,3,16,14,4,3,0,0,20,18,6,7,50.0,50.0,6,12,9,30,7,0,38,13
2012,3662,12,2013/2014,2013-11-23 00:00:00,Fulham,Swansea City,1,2,3.3,3.3,2.38,2,7,5,8,11,8,3,1,0,0,20,18,8,8,34.0,66.0,3,9,13,19,4,0,38,16
2013,3663,12,2013/2014,2013-11-23 00:00:00,Hull City,Crystal Palace,0,1,1.85,3.5,5.0,5,2,5,4,9,11,2,1,0,1,52,18,11,4,60.0,40.0,1,7,9,20,3,1,70,15
2014,3665,12,2013/2014,2013-11-23 00:00:00,Newcastle United,Norwich City,2,1,1.8,3.8,4.75,6,7,11,4,8,7,0,1,0,0,17,21,5,5,49.0,51.0,3,13,15,15,1,0,38,10
2015,3666,12,2013/2014,2013-11-23 00:00:00,Stoke City,Sunderland,2,0,2.15,3.3,3.9,8,4,6,8,11,6,2,1,0,1,24,16,3,7,50.0,50.0,2,12,14,17,3,1,40,10
2016,3668,12,2013/2014,2013-11-23 00:00:00,West Ham United,Chelsea,0,3,6.0,4.2,1.62,4,12,4,5,11,9,0,0,0,0,23,15,8,4,45.0,55.0,3,16,9,20,0,0,38,12
2017,3660,12,2013/2014,2013-11-24 00:00:00,Cardiff City,Manchester United,2,2,6.0,4.0,1.65,3,5,8,8,14,14,4,2,0,0,31,24,2,8,50.0,50.0,4,8,16,28,6,0,55,10
2018,3664,12,2013/2014,2013-11-24 00:00:00,Manchester City,Tottenham Hotspur,6,0,1.7,4.0,5.5,5,6,6,4,7,13,1,3,0,0,10,18,3,7,48.0,52.0,6,11,10,20,4,0,28,10
2019,3667,12,2013/2014,2013-11-25 00:00:00,West Bromwich Albion,Aston Villa,2,2,2.15,3.4,3.8,2,9,5,5,13,14,1,2,0,0,19,12,4,2,51.0,49.0,4,11,10,27,3,0,31,6
2020,3669,13,2013/2014,2013-11-30 00:00:00,Aston Villa,Sunderland,0,0,2.0,3.4,4.33,5,1,7,5,14,11,2,1,0,0,33,15,7,6,51.0,49.0,0,6,12,25,3,0,48,13
2021,3670,13,2013/2014,2013-11-30 00:00:00,Cardiff City,Arsenal,0,3,6.5,4.0,1.62,6,6,3,6,6,10,0,3,0,0,23,14,3,2,43.0,57.0,3,12,9,16,3,0,37,5
2022,3672,13,2013/2014,2013-11-30 00:00:00,Everton,Stoke City,4,0,1.62,4.0,6.25,14,4,5,0,9,16,0,3,0,0,20,12,9,3,55.0,45.0,4,18,5,25,3,0,32,12
2023,3675,13,2013/2014,2013-11-30 00:00:00,Newcastle United,West Bromwich Albion,2,1,2.05,3.5,4.0,4,4,4,7,15,15,1,2,0,0,25,13,3,3,54.0,46.0,3,8,11,30,3,0,38,6
2024,3676,13,2013/2014,2013-11-30 00:00:00,Norwich City,Crystal Palace,1,0,2.0,3.4,4.33,4,6,4,4,13,13,1,2,0,0,23,27,5,4,60.0,40.0,1,10,8,26,3,0,50,9
2025,3678,13,2013/2014,2013-11-30 00:00:00,West Ham United,Fulham,3,0,1.91,3.5,4.6,9,2,5,4,10,7,3,2,0,0,26,12,6,3,60.0,40.0,3,11,9,17,5,0,38,9
2026,3671,13,2013/2014,2013-12-01 00:00:00,Chelsea,Southampton,3,1,1.57,4.2,6.5,9,4,6,4,14,15,1,4,0,0,27,15,8,4,51.0,49.0,4,13,10,29,5,0,42,12
2027,3673,13,2013/2014,2013-12-01 00:00:00,Hull City,Liverpool,3,1,6.5,4.0,1.62,5,6,6,2,9,15,2,0,0,0,23,23,2,6,40.0,60.0,4,11,8,24,2,0,46,8
2028,3674,13,2013/2014,2013-12-01 00:00:00,Manchester City,Swansea City,3,0,1.29,6.0,13.0,3,5,12,5,7,8,1,0,0,0,16,10,5,4,45.0,55.0,3,8,17,15,1,0,26,9
2029,3677,13,2013/2014,2013-12-01 00:00:00,Tottenham Hotspur,Manchester United,2,2,2.8,3.5,2.63,5,1,3,3,9,16,1,3,0,0,24,24,7,7,40.0,60.0,4,6,6,25,4,0,48,14
2030,3688,14,2013/2014,2013-12-03 00:00:00,Crystal Palace,West Ham United,1,0,3.25,3.3,2.4,3,3,4,6,11,10,1,2,0,0,18,28,3,4,38.0,62.0,1,6,10,21,3,0,46,7
2031,3679,14,2013/2014,2013-12-04 00:00:00,Arsenal,Hull City,2,0,1.2,7.5,17.0,10,4,8,3,8,6,0,0,0,0,25,12,11,1,67.0,33.0,2,14,11,14,0,0,37,12
2032,3680,14,2013/2014,2013-12-04 00:00:00,Liverpool,Norwich City,5,1,1.29,6.0,12.0,15,6,9,7,10,6,3,1,0,0,16,12,4,0,61.0,39.0,6,21,16,16,4,0,28,4
2033,3681,14,2013/2014,2013-12-04 00:00:00,Manchester United,Everton,0,1,1.73,3.75,5.5,7,6,9,8,9,12,2,0,0,0,33,12,7,4,52.0,48.0,1,13,17,21,2,0,45,11
2034,3682,14,2013/2014,2013-12-04 00:00:00,Southampton,Aston Villa,2,3,1.7,3.8,5.75,9,0,7,3,10,14,3,2,0,0,44,6,8,2,77.0,23.0,5,9,10,24,5,0,50,10
2035,3683,14,2013/2014,2013-12-04 00:00:00,Stoke City,Cardiff City,0,0,2.1,3.4,4.0,4,6,10,6,8,6,2,2,0,0,26,17,2,5,60.0,40.0,0,10,16,14,4,0,43,7
2036,3684,14,2013/2014,2013-12-04 00:00:00,Sunderland,Chelsea,3,4,6.5,4.33,1.55,6,7,4,10,14,14,4,3,0,0,22,20,5,5,45.0,55.0,7,13,14,28,7,0,42,10
2037,3685,14,2013/2014,2013-12-04 00:00:00,Swansea City,Newcastle United,3,0,2.2,3.5,3.5,5,10,4,5,4,8,0,2,0,0,23,18,5,1,66.0,34.0,3,15,9,12,2,0,41,6
2038,3686,14,2013/2014,2013-12-04 00:00:00,West Bromwich Albion,Manchester City,2,3,6.0,4.2,1.62,4,5,7,8,8,10,1,1,0,0,20,17,3,3,41.0,59.0,5,9,15,18,2,0,37,6
2039,3687,14,2013/2014,2013-12-04 00:00:00,Fulham,Tottenham Hotspur,1,2,5.8,3.9,1.67,9,6,5,6,2,12,2,1,0,0,26,13,9,7,39.0,61.0,3,15,11,14,3,0,39,16
2040,3690,15,2013/2014,2013-12-07 00:00:00,Crystal Palace,Cardiff City,2,0,2.8,3.3,2.75,5,6,10,5,9,13,0,0,0,0,20,19,8,3,45.0,55.0,2,11,15,22,0,0,39,11
2041,3692,15,2013/2014,2013-12-07 00:00:00,Liverpool,West Ham United,4,1,1.29,6.0,12.0,20,6,10,2,9,12,0,3,0,1,28,18,8,4,65.0,35.0,5,26,12,21,3,1,46,12
2042,3693,15,2013/2014,2013-12-07 00:00:00,Manchester United,Newcastle United,0,1,1.53,4.33,7.0,6,2,2,6,10,20,0,2,0,0,23,18,4,4,48.0,52.0,1,8,8,30,2,0,41,8
2043,3694,15,2013/2014,2013-12-07 00:00:00,Southampton,Manchester City,1,1,5.25,3.8,1.75,4,3,9,8,6,8,0,2,0,0,22,18,5,4,54.0,46.0,2,7,17,14,2,0,40,9
2044,3695,15,2013/2014,2013-12-07 00:00:00,Stoke City,Chelsea,3,2,6.5,4.2,1.57,2,5,4,7,14,8,4,1,0,0,24,18,5,2,43.0,57.0,5,7,11,22,5,0,42,7
2045,3696,15,2013/2014,2013-12-07 00:00:00,Sunderland,Tottenham Hotspur,1,2,4.5,3.6,1.91,6,13,5,11,14,9,2,0,0,0,23,24,4,10,47.0,53.0,3,19,16,23,2,0,47,14
2046,3698,15,2013/2014,2013-12-07 00:00:00,West Bromwich Albion,Norwich City,0,2,1.8,3.75,5.0,14,1,10,4,10,6,1,3,0,0,43,16,10,3,64.0,36.0,2,15,14,16,4,0,59,13
2047,3689,15,2013/2014,2013-12-08 00:00:00,Arsenal,Everton,1,1,1.7,3.8,5.75,7,4,5,8,13,11,0,4,0,0,19,18,3,2,43.0,57.0,2,11,13,24,4,0,37,5
2048,3691,15,2013/2014,2013-12-08 00:00:00,Fulham,Aston Villa,2,0,2.75,3.3,2.8,12,6,9,6,12,12,0,2,0,0,21,22,4,7,54.0,46.0,2,18,15,24,2,0,43,11
2049,3697,15,2013/2014,2013-12-09 00:00:00,Swansea City,Hull City,1,1,1.75,3.75,5.5,5,6,5,1,8,7,3,3,0,0,32,9,12,1,64.0,36.0,2,11,6,15,6,0,41,13
2050,3700,16,2013/2014,2013-12-14 00:00:00,Cardiff City,West Bromwich Albion,1,0,2.63,3.4,2.88,7,5,5,6,14,12,2,1,0,0,29,27,8,6,50.0,50.0,1,12,11,26,3,0,56,14
2051,3701,16,2013/2014,2013-12-14 00:00:00,Chelsea,Crystal Palace,2,1,1.18,8.0,19.0,9,6,6,4,13,7,2,1,0,0,20,9,3,1,70.0,30.0,3,15,10,20,3,0,29,4
2052,3702,16,2013/2014,2013-12-14 00:00:00,Everton,Fulham,4,1,1.36,5.0,10.5,10,4,6,6,8,8,1,2,0,0,24,8,12,2,59.0,41.0,5,14,12,16,3,0,32,14
2053,3703,16,2013/2014,2013-12-14 00:00:00,Hull City,Stoke City,0,0,2.3,3.3,3.5,7,2,6,7,10,13,1,0,0,0,17,20,7,5,47.0,53.0,0,9,13,23,1,0,37,12
2054,3704,16,2013/2014,2013-12-14 00:00:00,Manchester City,Arsenal,6,3,1.83,3.75,4.75,6,4,11,4,12,6,2,1,0,0,26,29,8,8,51.0,49.0,9,10,15,18,3,0,55,16
2055,3705,16,2013/2014,2013-12-14 00:00:00,Newcastle United,Southampton,1,1,2.4,3.4,3.2,7,7,7,4,8,16,1,2,0,0,28,12,11,3,39.0,61.0,2,14,11,24,3,0,40,14
2056,3708,16,2013/2014,2013-12-14 00:00:00,West Ham United,Sunderland,0,0,1.95,3.6,4.33,2,10,10,8,11,5,1,0,0,0,23,29,2,9,41.0,59.0,0,12,18,16,1,0,52,11
2057,3699,16,2013/2014,2013-12-15 00:00:00,Aston Villa,Manchester United,0,3,5.25,3.8,1.75,10,3,5,6,15,8,4,2,0,0,22,14,3,4,44.0,56.0,3,13,11,23,6,0,36,7
2058,3706,16,2013/2014,2013-12-15 00:00:00,Norwich City,Swansea City,1,1,2.88,3.3,2.7,8,5,11,5,11,11,0,3,0,0,21,16,8,5,38.0,62.0,2,13,16,22,3,0,37,13
2059,3707,16,2013/2014,2013-12-15 00:00:00,Tottenham Hotspur,Liverpool,0,5,2.5,3.4,3.0,2,6,6,9,16,15,3,0,1,0,17,12,2,9,47.0,53.0,5,8,15,31,3,1,29,11
2060,3710,17,2013/2014,2013-12-21 00:00:00,Crystal Palace,Newcastle United,0,3,3.25,3.4,2.38,6,4,3,7,10,11,1,2,0,0,12,20,3,7,33.0,67.0,3,10,10,21,3,0,32,10
2061,3711,17,2013/2014,2013-12-21 00:00:00,Fulham,Manchester City,2,4,9.5,5.25,1.36,8,11,4,2,6,15,1,1,0,0,24,16,4,4,46.0,54.0,6,19,6,21,2,0,40,8
2062,3712,17,2013/2014,2013-12-21 00:00:00,Liverpool,Cardiff City,3,1,1.2,7.5,16.0,11,6,15,5,10,13,2,0,0,0,25,16,9,5,69.0,31.0,4,17,20,23,2,0,41,14
2063,3713,17,2013/2014,2013-12-21 00:00:00,Manchester United,West Ham United,3,1,1.36,5.25,10.0,7,2,9,1,8,14,1,4,0,0,30,20,8,2,61.0,39.0,4,9,10,22,5,0,50,10
2064,3715,17,2013/2014,2013-12-21 00:00:00,Stoke City,Aston Villa,2,1,2.3,3.25,3.5,4,8,6,5,12,17,1,5,0,0,26,20,6,7,54.0,46.0,3,12,11,29,6,0,46,13
2065,3716,17,2013/2014,2013-12-21 00:00:00,Sunderland,Norwich City,0,0,2.05,3.5,4.0,8,9,11,4,13,10,2,1,1,0,22,24,6,7,59.0,41.0,0,17,15,23,3,1,46,13
2066,3718,17,2013/2014,2013-12-21 00:00:00,West Bromwich Albion,Hull City,1,1,1.95,3.5,4.5,6,2,5,3,9,16,2,1,0,0,29,13,9,2,60.0,40.0,2,8,8,25,3,0,42,11
2067,3714,17,2013/2014,2013-12-22 00:00:00,Southampton,Tottenham Hotspur,2,3,2.55,3.3,3.0,6,4,5,6,11,18,1,1,0,0,24,20,2,5,57.0,43.0,5,10,11,29,2,0,44,7
2068,3717,17,2013/2014,2013-12-22 00:00:00,Swansea City,Everton,1,2,3.0,3.4,2.5,4,6,9,6,11,11,1,0,0,0,18,14,4,8,54.0,46.0,3,10,15,22,1,0,32,12
2069,3709,17,2013/2014,2013-12-23 00:00:00,Arsenal,Chelsea,0,0,2.38,3.4,3.25,5,6,2,5,8,13,2,1,0,0,24,16,8,6,60.0,40.0,0,11,7,21,3,0,40,14
2070,3719,18,2013/2014,2013-12-26 00:00:00,Aston Villa,Crystal Palace,0,1,1.91,3.5,4.5,5,7,5,4,11,8,2,2,0,0,31,22,7,5,65.0,35.0,1,12,9,19,4,0,53,12
2071,3720,18,2013/2014,2013-12-26 00:00:00,Cardiff City,Southampton,0,3,3.3,3.3,2.38,1,3,8,3,11,13,1,2,0,0,27,15,6,3,40.0,60.0,3,4,11,24,3,0,42,9
2072,3721,18,2013/2014,2013-12-26 00:00:00,Chelsea,Swansea City,1,0,1.33,5.5,10.0,12,2,7,5,14,9,1,1,0,0,27,20,13,7,48.0,52.0,1,14,12,23,2,0,47,20
2073,3722,18,2013/2014,2013-12-26 00:00:00,Everton,Sunderland,0,1,1.36,5.25,9.5,16,5,8,6,12,6,1,0,1,0,23,6,11,2,54.0,46.0,1,21,14,18,1,1,29,13
2074,3723,18,2013/2014,2013-12-26 00:00:00,Hull City,Manchester United,2,3,7.0,4.2,1.55,5,5,8,5,14,13,2,3,0,0,23,20,6,5,38.0,62.0,5,10,13,27,5,0,43,11
2075,3724,18,2013/2014,2013-12-26 00:00:00,Manchester City,Liverpool,2,1,1.75,4.2,4.6,12,8,6,5,9,8,1,3,0,0,23,26,7,6,52.0,48.0,3,20,11,17,4,0,49,13
2076,3725,18,2013/2014,2013-12-26 00:00:00,Newcastle United,Stoke City,5,1,1.75,3.8,5.25,8,4,13,5,10,8,1,2,0,1,41,12,8,2,58.0,42.0,6,12,18,18,3,1,53,10
2077,3726,18,2013/2014,2013-12-26 00:00:00,Norwich City,Fulham,1,2,2.05,3.5,4.0,7,4,7,6,14,11,3,0,0,0,23,16,5,4,50.0,50.0,3,11,13,25,3,0,39,9
2078,3727,18,2013/2014,2013-12-26 00:00:00,Tottenham Hotspur,West Bromwich Albion,1,1,1.53,4.33,7.0,9,3,9,3,8,12,3,2,0,0,44,9,13,2,65.0,35.0,2,12,12,20,5,0,53,15
2079,3728,18,2013/2014,2013-12-26 00:00:00,West Ham United,Arsenal,1,3,6.5,4.0,1.62,4,19,6,10,10,6,1,1,0,0,27,34,0,10,32.0,68.0,4,23,16,16,2,0,61,10
2080,3729,19,2013/2014,2013-12-28 00:00:00,Aston Villa,Swansea City,1,1,3.0,3.3,2.55,3,8,3,5,11,8,3,2,0,0,14,28,2,8,27.0,73.0,2,11,8,19,5,0,42,10
2081,3730,19,2013/2014,2013-12-28 00:00:00,Cardiff City,Sunderland,2,2,2.38,3.25,3.4,7,11,6,8,13,11,3,2,0,0,29,31,6,6,44.0,56.0,4,18,14,24,5,0,60,12
2082,3733,19,2013/2014,2013-12-28 00:00:00,Hull City,Fulham,6,0,2.05,3.4,4.1,13,4,6,2,11,9,0,0,0,0,30,6,6,1,50.0,50.0,6,17,8,20,0,0,36,7
2083,3734,19,2013/2014,2013-12-28 00:00:00,Manchester City,Crystal Palace,1,0,1.13,9.5,29.0,13,4,10,5,12,7,1,1,0,0,39,15,12,5,77.0,23.0,1,17,15,19,2,0,54,17
2084,3736,19,2013/2014,2013-12-28 00:00:00,Norwich City,Manchester United,0,1,6.5,4.2,1.57,8,4,9,4,11,10,4,3,0,0,28,19,8,3,45.0,55.0,1,12,13,21,7,0,47,11
2085,3738,19,2013/2014,2013-12-28 00:00:00,West Ham United,West Bromwich Albion,3,3,2.38,3.4,3.25,6,16,8,4,9,13,3,2,0,0,25,20,6,5,46.0,54.0,6,22,12,22,5,0,45,11
2086,3731,19,2013/2014,2013-12-29 00:00:00,Chelsea,Liverpool,2,1,2.2,3.5,3.5,5,8,5,1,17,18,4,1,0,0,13,10,4,2,53.0,47.0,3,13,6,35,5,0,23,6
2087,3732,19,2013/2014,2013-12-29 00:00:00,Everton,Southampton,2,1,1.83,3.7,4.75,4,5,3,7,8,14,2,4,0,0,8,23,2,3,45.0,55.0,3,9,10,22,6,0,31,5
2088,3735,19,2013/2014,2013-12-29 00:00:00,Newcastle United,Arsenal,0,1,4.0,3.7,2.0,6,5,7,4,11,8,0,3,0,0,32,18,4,1,46.0,54.0,1,11,11,19,3,0,50,5
2089,3737,19,2013/2014,2013-12-29 00:00:00,Tottenham Hotspur,Stoke City,3,0,1.44,4.33,8.0,8,1,9,1,5,13,2,2,0,0,19,9,6,1,68.0,32.0,3,9,10,18,4,0,28,7
2090,3749,20,2013/2014,2014-01-01 00:00:00,Arsenal,Cardiff City,2,0,1.29,6.0,13.0,13,6,14,3,6,10,1,2,0,0,40,10,12,2,69.0,31.0,2,19,17,16,3,0,50,14
2091,3750,20,2013/2014,2014-01-01 00:00:00,Crystal Palace,Norwich City,1,1,2.38,3.3,3.3,6,4,6,3,12,10,3,2,0,0,37,13,9,4,45.0,55.0,2,10,9,22,5,0,50,13
2092,3751,20,2013/2014,2014-01-01 00:00:00,Fulham,West Ham United,2,1,2.5,3.3,3.1,11,3,10,4,7,5,2,2,0,1,30,12,12,4,69.0,31.0,3,14,14,12,4,1,42,16
2093,3752,20,2013/2014,2014-01-01 00:00:00,Liverpool,Hull City,2,0,1.3,6.0,11.0,4,3,8,6,15,14,1,2,0,0,14,17,3,4,60.0,40.0,2,7,14,29,3,0,31,7
2094,3753,20,2013/2014,2014-01-01 00:00:00,Manchester United,Tottenham Hotspur,1,2,1.8,3.8,4.75,10,3,6,3,7,8,2,1,0,0,55,9,13,2,60.0,40.0,3,13,9,15,3,0,64,15
2095,3754,20,2013/2014,2014-01-01 00:00:00,Southampton,Chelsea,0,3,4.0,3.5,2.05,7,3,3,4,13,10,4,1,0,0,19,20,6,8,57.0,43.0,3,10,7,23,5,0,39,14
2096,3755,20,2013/2014,2014-01-01 00:00:00,Stoke City,Everton,1,1,4.0,3.3,2.1,5,8,4,8,15,11,4,1,0,0,21,19,2,5,40.0,60.0,2,13,12,26,5,0,40,7
2097,3756,20,2013/2014,2014-01-01 00:00:00,Sunderland,Aston Villa,0,1,2.15,3.4,3.75,7,7,8,5,6,11,4,3,0,0,19,8,10,2,65.0,35.0,1,14,13,17,7,0,27,12
2098,3757,20,2013/2014,2014-01-01 00:00:00,Swansea City,Manchester City,2,3,5.75,4.25,1.62,6,5,8,6,6,10,2,5,0,0,19,20,8,6,51.0,49.0,5,11,14,16,7,0,39,14
2099,3758,20,2013/2014,2014-01-01 00:00:00,West Bromwich Albion,Newcastle United,1,0,2.6,3.4,2.88,5,6,7,2,8,14,0,0,0,1,17,19,3,4,47.0,53.0,1,11,9,22,0,1,36,7
2100,3760,21,2013/2014,2014-01-11 00:00:00,Cardiff City,West Ham United,0,2,2.0,3.5,4.1,10,2,8,8,6,16,1,4,0,0,38,25,8,7,63.0,37.0,2,12,16,22,5,0,63,15
2101,3761,21,2013/2014,2014-01-11 00:00:00,Everton,Norwich City,2,0,1.4,5.0,9.0,7,7,12,5,6,13,1,2,0,0,33,18,10,5,63.0,37.0,2,14,17,19,3,0,51,15
2102,3762,21,2013/2014,2014-01-11 00:00:00,Fulham,Sunderland,1,4,2.2,3.3,3.75,5,3,8,3,16,12,3,3,0,0,24,17,10,6,59.0,41.0,5,8,11,28,6,0,41,16
2103,3763,21,2013/2014,2014-01-11 00:00:00,Hull City,Chelsea,0,2,6.5,4.0,1.6,5,7,5,5,12,7,2,1,0,0,14,19,1,7,43.0,57.0,2,12,10,19,3,0,33,8
2104,3764,21,2013/2014,2014-01-11 00:00:00,Manchester United,Swansea City,2,0,1.57,4.0,7.0,4,5,10,8,9,12,0,2,0,0,22,22,3,5,39.0,61.0,2,9,18,21,2,0,44,8
2105,3766,21,2013/2014,2014-01-11 00:00:00,Southampton,West Bromwich Albion,1,0,1.83,3.7,4.75,8,2,9,2,11,16,1,2,0,0,27,19,4,4,63.0,37.0,1,10,11,27,3,0,46,8
2106,3768,21,2013/2014,2014-01-11 00:00:00,Tottenham Hotspur,Crystal Palace,2,0,1.36,5.0,10.0,3,3,5,12,12,13,1,2,0,0,21,22,5,11,69.0,31.0,2,6,17,25,3,0,43,16
2107,3765,21,2013/2014,2014-01-12 00:00:00,Newcastle United,Manchester City,0,2,5.25,4.0,1.7,7,6,7,6,18,16,4,2,0,0,33,19,5,6,54.0,46.0,2,13,13,34,6,0,52,11
2108,3767,21,2013/2014,2014-01-12 00:00:00,Stoke City,Liverpool,3,5,5.75,4.0,1.67,8,5,5,5,10,8,1,1,0,0,40,14,11,2,50.0,50.0,8,13,10,18,2,0,54,13
2109,3759,21,2013/2014,2014-01-13 00:00:00,Aston Villa,Arsenal,1,2,6.0,4.2,1.62,6,4,4,3,11,9,2,2,0,0,25,16,3,5,35.0,65.0,3,10,7,20,4,0,41,8
2110,3769,22,2013/2014,2014-01-18 00:00:00,Arsenal,Fulham,2,0,1.22,7.0,15.0,12,6,8,3,6,6,0,0,0,0,20,14,4,4,59.0,41.0,2,18,11,12,0,0,34,8
2111,3771,22,2013/2014,2014-01-18 00:00:00,Crystal Palace,Stoke City,1,0,2.35,3.2,3.5,6,8,4,9,7,15,0,2,0,0,20,21,4,3,44.0,56.0,1,14,13,22,2,0,41,7
2112,3772,22,2013/2014,2014-01-18 00:00:00,Liverpool,Aston Villa,2,2,1.22,7.0,15.0,5,4,8,5,15,17,0,4,0,0,10,15,2,3,56.0,44.0,4,9,13,32,4,0,25,5
2113,3773,22,2013/2014,2014-01-18 00:00:00,Manchester City,Cardiff City,4,2,1.13,11.0,23.0,7,6,9,0,6,5,2,0,0,0,37,17,10,7,63.0,37.0,6,13,9,11,2,0,54,17
2114,3774,22,2013/2014,2014-01-18 00:00:00,Norwich City,Hull City,1,0,2.4,3.3,3.25,8,2,11,8,8,16,1,3,0,0,30,28,10,8,56.0,44.0,1,10,19,24,4,0,58,18
2115,3775,22,2013/2014,2014-01-18 00:00:00,Sunderland,Southampton,2,2,3.2,3.3,2.45,9,14,0,4,7,7,2,0,0,0,23,30,4,7,37.0,63.0,4,23,4,14,2,0,53,11
2116,3778,22,2013/2014,2014-01-18 00:00:00,West Ham United,Newcastle United,1,3,3.0,3.4,2.5,4,10,6,6,10,6,0,0,0,0,30,13,4,3,47.0,53.0,4,14,12,16,0,0,43,7
2117,3770,22,2013/2014,2014-01-19 00:00:00,Chelsea,Manchester United,3,1,1.73,3.8,5.5,4,5,5,2,16,20,1,3,0,1,10,24,5,4,46.0,54.0,4,9,7,36,4,1,34,9
2118,3776,22,2013/2014,2014-01-19 00:00:00,Swansea City,Tottenham Hotspur,1,3,3.25,3.4,2.38,2,6,10,3,7,8,2,1,0,0,18,17,8,2,56.0,44.0,4,8,13,15,3,0,35,10
2119,3777,22,2013/2014,2014-01-20 00:00:00,West Bromwich Albion,Everton,1,1,3.5,3.4,2.25,10,7,2,5,17,11,3,2,0,0,26,18,4,2,50.0,50.0,2,17,7,28,5,0,44,6
2120,3780,23,2013/2014,2014-01-28 00:00:00,Crystal Palace,Hull City,1,0,2.5,3.2,3.2,3,6,7,7,14,8,4,0,0,1,19,26,8,3,38.0,62.0,1,9,14,22,4,1,45,11
2121,3781,23,2013/2014,2014-01-28 00:00:00,Liverpool,Everton,4,0,1.83,3.9,4.5,8,15,7,6,11,12,0,3,0,0,8,20,5,8,38.0,62.0,4,23,13,23,3,0,28,13
2122,3782,23,2013/2014,2014-01-28 00:00:00,Manchester United,Cardiff City,2,0,1.25,6.5,15.0,7,4,8,2,9,8,0,1,0,0,22,22,5,5,46.0,54.0,2,11,10,17,1,0,44,10
2123,3783,23,2013/2014,2014-01-28 00:00:00,Norwich City,Newcastle United,0,0,2.7,3.4,2.8,4,12,4,8,12,7,1,1,1,1,18,32,7,7,44.0,56.0,0,16,12,19,2,2,50,14
2124,3784,23,2013/2014,2014-01-28 00:00:00,Southampton,Arsenal,2,2,4.33,3.5,1.95,10,2,4,3,9,4,2,1,0,1,31,19,7,5,52.0,48.0,4,12,7,13,3,1,50,12
2125,3786,23,2013/2014,2014-01-28 00:00:00,Swansea City,Fulham,2,0,1.75,3.75,5.25,7,7,6,7,13,10,1,1,0,0,22,19,5,8,61.0,39.0,2,14,13,23,2,0,41,13
2126,3779,23,2013/2014,2014-01-29 00:00:00,Aston Villa,West Bromwich Albion,4,3,2.6,3.3,3.0,4,3,2,7,14,10,1,3,0,0,13,17,3,3,45.0,55.0,7,7,9,24,4,0,30,6
2127,3785,23,2013/2014,2014-01-29 00:00:00,Sunderland,Stoke City,1,0,2.1,3.4,3.9,8,8,7,5,16,15,2,3,0,0,12,20,2,3,47.0,53.0,1,16,12,31,5,0,32,5
2128,3787,23,2013/2014,2014-01-29 00:00:00,Chelsea,West Ham United,0,0,1.18,8.0,19.0,19,1,18,1,11,12,1,3,0,0,36,12,13,3,71.0,29.0,0,20,19,23,4,0,48,16
2129,3788,23,2013/2014,2014-01-29 00:00:00,Tottenham Hotspur,Manchester City,1,5,3.75,3.75,2.05,2,8,2,12,12,10,1,4,1,0,11,18,3,5,35.0,65.0,6,10,14,22,5,1,29,8
2130,3790,24,2013/2014,2014-02-01 00:00:00,Cardiff City,Norwich City,2,1,2.3,3.4,3.4,6,7,6,17,7,9,1,4,0,0,26,34,7,13,50.0,50.0,3,13,23,16,5,0,60,20
2131,3791,24,2013/2014,2014-02-01 00:00:00,Everton,Aston Villa,2,1,1.53,4.33,7.0,10,0,3,3,3,17,1,0,0,0,28,7,13,1,71.0,29.0,3,10,6,20,1,0,35,14
2132,3792,24,2013/2014,2014-02-01 00:00:00,Fulham,Southampton,0,3,3.6,3.4,2.2,4,6,5,8,8,9,0,3,0,0,19,28,4,5,38.0,62.0,3,10,13,17,3,0,47,9
2133,3793,24,2013/2014,2014-02-01 00:00:00,Hull City,Tottenham Hotspur,1,1,4.0,3.5,2.05,3,8,5,7,12,9,1,1,0,0,14,23,4,10,39.0,61.0,2,11,12,21,2,0,37,14
2134,3795,24,2013/2014,2014-02-01 00:00:00,Newcastle United,Sunderland,0,3,1.95,3.5,4.33,15,5,9,8,18,13,2,2,0,0,26,13,7,3,51.0,49.0,3,20,17,31,4,0,39,10
2135,3796,24,2013/2014,2014-02-01 00:00:00,Stoke City,Manchester United,2,1,7.0,4.0,1.57,6,5,5,8,16,7,2,2,0,0,18,21,6,9,42.0,58.0,3,11,13,23,4,0,39,15
2136,3798,24,2013/2014,2014-02-01 00:00:00,West Ham United,Swansea City,2,0,2.9,3.4,2.6,2,7,5,9,6,7,1,0,1,0,21,43,8,11,36.0,64.0,2,9,14,13,1,1,64,19
2137,3789,24,2013/2014,2014-02-02 00:00:00,Arsenal,Crystal Palace,2,0,1.22,7.0,16.0,5,4,4,5,9,14,1,2,0,0,15,16,6,5,73.0,27.0,2,9,9,23,3,0,31,11
2138,3797,24,2013/2014,2014-02-02 00:00:00,West Bromwich Albion,Liverpool,1,1,5.75,4.33,1.62,5,6,6,4,13,16,4,2,0,0,21,15,3,4,51.0,49.0,2,11,10,29,6,0,36,7
2139,3794,24,2013/2014,2014-02-03 00:00:00,Manchester City,Chelsea,0,1,1.85,3.8,4.5,8,7,17,8,11,14,3,3,0,0,35,9,12,6,64.0,36.0,1,15,25,25,6,0,44,18
2140,3799,25,2013/2014,2014-02-08 00:00:00,Crystal Palace,West Bromwich Albion,3,1,2.6,3.3,3.0,4,10,1,5,13,12,0,3,0,0,15,23,4,7,36.0,64.0,4,14,6,25,3,0,38,11
2141,3800,25,2013/2014,2014-02-08 00:00:00,Aston Villa,West Ham United,0,2,2.1,3.5,3.8,4,5,12,4,9,9,0,2,0,0,25,15,8,10,68.0,32.0,2,9,16,18,2,0,40,18
2142,3801,25,2013/2014,2014-02-08 00:00:00,Chelsea,Newcastle United,3,0,1.25,6.25,15.0,6,7,9,5,7,10,0,3,0,0,18,10,6,5,58.0,42.0,3,13,14,17,3,0,28,11
2143,3802,25,2013/2014,2014-02-08 00:00:00,Liverpool,Arsenal,5,1,2.2,3.6,3.4,8,6,7,4,14,13,1,2,0,0,15,18,6,6,41.0,59.0,6,14,11,27,3,0,33,12
2144,3804,25,2013/2014,2014-02-08 00:00:00,Norwich City,Manchester City,0,0,9.0,5.5,1.36,4,5,4,8,8,6,2,1,0,0,17,43,4,14,32.0,68.0,0,9,12,14,3,0,60,18
2145,3805,25,2013/2014,2014-02-08 00:00:00,Southampton,Stoke City,2,2,1.55,4.0,7.5,7,1,7,0,6,15,0,4,0,0,21,19,7,4,61.0,39.0,4,8,7,21,4,0,40,11
2146,3806,25,2013/2014,2014-02-08 00:00:00,Sunderland,Hull City,0,2,2.15,3.4,3.8,4,8,3,11,11,15,1,3,1,0,9,18,2,6,45.0,55.0,2,12,14,26,4,1,27,8
2147,3807,25,2013/2014,2014-02-08 00:00:00,Swansea City,Cardiff City,3,0,1.85,3.6,4.75,8,2,6,5,7,7,1,1,0,0,22,10,5,1,62.0,38.0,3,10,11,14,2,0,32,6
2148,3803,25,2013/2014,2014-02-09 00:00:00,Manchester United,Fulham,2,2,1.2,7.0,19.0,16,2,11,2,3,6,0,0,0,0,72,6,10,1,76.0,24.0,4,18,13,9,0,0,78,11
2149,3808,25,2013/2014,2014-02-09 00:00:00,Tottenham Hotspur,Everton,1,0,2.1,3.5,3.75,4,4,5,5,9,11,1,0,0,0,21,21,9,7,46.0,54.0,1,8,10,20,1,0,42,16
2150,3810,26,2013/2014,2014-02-11 00:00:00,Cardiff City,Aston Villa,0,0,2.5,3.4,3.0,4,6,6,9,5,9,0,0,0,0,19,27,7,9,46.0,54.0,0,10,15,14,0,0,46,16
2151,3811,26,2013/2014,2014-02-11 00:00:00,Hull City,Southampton,0,1,3.0,3.25,2.6,5,9,7,6,5,8,0,3,0,0,19,12,2,2,37.0,63.0,1,14,13,13,3,0,31,4
2152,3813,26,2013/2014,2014-02-11 00:00:00,West Bromwich Albion,Chelsea,1,1,7.5,4.5,1.5,2,6,10,8,10,13,3,4,0,0,17,18,5,8,39.0,61.0,2,8,18,23,7,0,35,13
2153,3814,26,2013/2014,2014-02-11 00:00:00,West Ham United,Norwich City,2,0,2.05,3.5,4.0,7,7,4,5,12,17,1,3,0,0,32,22,5,5,49.0,51.0,2,14,9,29,4,0,54,10
2154,3809,26,2013/2014,2014-02-12 00:00:00,Arsenal,Manchester United,0,0,2.15,3.5,3.6,11,2,7,4,11,15,1,2,0,0,25,17,5,5,57.0,43.0,0,13,11,26,3,0,42,10
2155,3812,26,2013/2014,2014-02-12 00:00:00,Stoke City,Swansea City,1,1,2.7,3.25,2.9,3,7,3,4,11,11,2,2,0,0,11,17,2,5,35.0,65.0,2,10,7,22,4,0,28,7
2156,3816,26,2013/2014,2014-02-12 00:00:00,Fulham,Liverpool,2,3,8.0,5.25,1.4,5,6,6,12,7,8,4,3,0,0,14,16,7,5,30.0,70.0,5,11,18,15,7,0,30,12
2157,3818,26,2013/2014,2014-02-12 00:00:00,Newcastle United,Tottenham Hotspur,0,4,3.3,3.5,2.3,8,6,2,4,6,10,0,0,0,0,27,10,8,6,50.0,50.0,4,14,6,16,0,0,37,14
2158,3819,27,2013/2014,2014-02-22 00:00:00,Arsenal,Sunderland,4,1,1.33,5.5,11.0,6,2,2,2,9,12,0,1,0,0,15,11,7,3,65.0,35.0,5,8,4,21,1,0,26,10
2159,3820,27,2013/2014,2014-02-22 00:00:00,Cardiff City,Hull City,0,4,2.75,3.2,2.88,13,2,10,4,4,11,1,1,0,0,37,8,9,2,56.0,44.0,4,15,14,15,2,0,45,11
2160,3821,27,2013/2014,2014-02-22 00:00:00,Chelsea,Everton,1,0,1.57,4.0,7.0,14,7,11,1,15,13,1,2,0,0,25,16,8,8,47.0,53.0,1,21,12,28,3,0,41,16
2161,3822,27,2013/2014,2014-02-22 00:00:00,Crystal Palace,Manchester United,0,2,6.5,4.0,1.6,11,8,3,6,12,9,0,2,0,0,27,17,6,4,34.0,66.0,2,19,9,21,2,0,44,10
2162,3824,27,2013/2014,2014-02-22 00:00:00,Manchester City,Stoke City,1,0,1.18,8.0,19.0,11,3,9,5,16,13,3,1,0,0,25,14,8,3,76.0,24.0,1,14,14,29,4,0,39,11
2163,3827,27,2013/2014,2014-02-22 00:00:00,West Bromwich Albion,Fulham,1,1,1.8,3.9,4.75,11,2,4,4,13,15,3,3,0,0,25,11,8,2,64.0,36.0,2,13,8,28,6,0,36,10
2164,3828,27,2013/2014,2014-02-22 00:00:00,West Ham United,Southampton,3,1,3.2,3.4,2.4,2,6,4,14,11,9,0,1,0,0,24,28,5,11,32.0,68.0,4,8,18,20,1,0,52,16
2165,3823,27,2013/2014,2014-02-23 00:00:00,Liverpool,Swansea City,4,3,1.3,5.75,12.0,10,5,7,5,10,11,1,0,0,0,11,13,3,5,54.0,46.0,7,15,12,21,1,0,24,8
2166,3825,27,2013/2014,2014-02-23 00:00:00,Newcastle United,Aston Villa,1,0,2.1,3.4,3.9,8,5,13,6,12,11,2,2,0,0,31,18,10,1,54.0,46.0,1,13,19,23,4,0,49,11
2167,3826,27,2013/2014,2014-02-23 00:00:00,Norwich City,Tottenham Hotspur,1,0,3.8,3.5,2.1,7,4,6,4,9,14,1,3,0,0,15,22,5,3,41.0,59.0,1,11,10,23,4,0,37,8
2168,3830,28,2013/2014,2014-03-01 00:00:00,Everton,West Ham United,1,0,1.53,4.2,7.5,5,1,14,6,9,7,1,1,0,0,20,15,11,5,67.0,33.0,1,6,20,16,2,0,35,16
2169,3831,28,2013/2014,2014-03-01 00:00:00,Fulham,Chelsea,1,3,8.0,4.75,1.45,3,8,4,5,14,13,2,1,0,0,26,15,5,4,42.0,58.0,4,11,9,27,3,0,41,9
2170,3832,28,2013/2014,2014-03-01 00:00:00,Hull City,Newcastle United,1,4,2.45,3.2,3.3,5,7,7,6,13,11,3,2,0,0,30,16,6,3,47.0,53.0,5,12,13,24,5,0,46,9
2171,3834,28,2013/2014,2014-03-01 00:00:00,Southampton,Liverpool,0,3,3.75,3.75,2.05,7,3,7,6,9,4,1,2,0,0,21,11,4,5,58.0,42.0,3,10,13,13,3,0,32,9
2172,3835,28,2013/2014,2014-03-01 00:00:00,Stoke City,Arsenal,1,0,5.5,3.8,1.73,6,6,4,4,14,10,3,1,0,0,18,22,3,4,44.0,56.0,1,12,8,24,4,0,40,7
2173,3829,28,2013/2014,2014-03-02 00:00:00,Aston Villa,Norwich City,4,1,2.1,3.4,3.9,3,5,4,2,13,9,0,3,0,0,24,11,6,2,57.0,43.0,5,8,6,22,3,0,35,8
2174,3837,28,2013/2014,2014-03-02 00:00:00,Swansea City,Crystal Palace,1,1,1.85,3.5,5.0,4,4,2,3,8,9,1,4,1,0,16,24,1,4,69.0,31.0,2,8,5,17,5,1,40,5
2175,3838,28,2013/2014,2014-03-02 00:00:00,Tottenham Hotspur,Cardiff City,1,0,1.33,5.25,12.0,8,5,6,3,13,12,1,3,0,0,26,21,4,7,61.0,39.0,1,13,9,25,4,0,47,11
2176,3840,29,2013/2014,2014-03-08 00:00:00,Cardiff City,Fulham,3,1,2.35,3.5,3.2,10,8,7,4,8,12,1,0,0,0,27,26,7,6,48.0,52.0,4,18,11,20,1,0,53,13
2177,3841,29,2013/2014,2014-03-08 00:00:00,Chelsea,Tottenham Hotspur,4,0,1.57,4.0,7.0,2,3,5,2,11,17,2,3,0,1,14,15,5,4,53.0,47.0,4,5,7,28,5,1,29,9
2178,3842,29,2013/2014,2014-03-08 00:00:00,Crystal Palace,Southampton,0,1,3.9,3.3,2.15,3,6,3,3,14,19,1,5,0,0,29,17,8,3,35.0,65.0,1,9,6,33,6,0,46,11
2179,3846,29,2013/2014,2014-03-08 00:00:00,Norwich City,Stoke City,1,1,2.25,3.3,3.6,5,3,6,2,9,12,0,2,0,1,22,16,3,1,52.0,48.0,2,8,8,21,2,1,38,4
2180,3847,29,2013/2014,2014-03-08 00:00:00,West Bromwich Albion,Manchester United,0,3,5.0,3.6,1.83,6,5,9,5,11,10,1,2,0,0,28,33,3,5,45.0,55.0,3,11,14,21,3,0,61,8
2181,3859,30,2013/2014,2014-03-15 00:00:00,Swansea City,West Bromwich Albion,1,2,1.95,3.6,4.33,7,7,5,4,7,13,1,3,0,0,28,19,4,1,63.0,37.0,3,14,9,20,4,0,47,5
2182,3860,30,2013/2014,2014-03-15 00:00:00,Aston Villa,Chelsea,1,0,7.0,4.33,1.53,5,7,7,6,15,8,4,2,0,1,22,17,4,5,38.0,62.0,1,12,13,23,6,1,39,9
2183,3861,30,2013/2014,2014-03-15 00:00:00,Everton,Cardiff City,2,1,1.36,5.0,11.0,12,5,6,4,9,9,1,3,0,0,31,18,10,5,68.0,32.0,3,17,10,18,4,0,49,15
2184,3862,30,2013/2014,2014-03-15 00:00:00,Fulham,Newcastle United,1,0,2.9,3.4,2.6,5,5,5,6,12,6,1,0,0,0,27,33,9,7,39.0,61.0,1,10,11,18,1,0,60,16
2185,3863,30,2013/2014,2014-03-15 00:00:00,Hull City,Manchester City,0,2,6.5,4.33,1.57,7,1,6,4,10,14,2,2,0,1,38,9,3,4,54.0,46.0,2,8,10,24,4,1,47,7
2186,3865,30,2013/2014,2014-03-15 00:00:00,Southampton,Norwich City,4,2,1.62,4.0,6.5,4,2,8,1,11,16,1,2,0,0,15,15,6,1,64.0,36.0,6,6,9,27,3,0,30,7
2187,3866,30,2013/2014,2014-03-15 00:00:00,Stoke City,West Ham United,3,1,2.25,3.3,3.6,7,3,3,4,13,12,1,1,0,0,11,25,6,4,55.0,45.0,4,10,7,25,2,0,36,10
2188,3867,30,2013/2014,2014-03-15 00:00:00,Sunderland,Crystal Palace,0,0,2.15,3.3,3.9,6,6,11,5,16,14,4,4,0,0,27,6,6,2,66.0,34.0,0,12,16,30,8,0,33,8
2189,3864,30,2013/2014,2014-03-16 00:00:00,Manchester United,Liverpool,0,3,2.5,3.6,2.9,6,7,8,7,14,13,2,4,0,0,21,12,3,4,50.0,50.0,3,13,15,27,6,0,33,7
2190,3868,30,2013/2014,2014-03-16 00:00:00,Tottenham Hotspur,Arsenal,0,1,3.1,3.4,2.45,8,2,7,4,19,11,5,3,0,0,39,9,5,2,58.0,42.0,1,10,11,30,8,0,48,7
2191,3870,31,2013/2014,2014-03-22 00:00:00,Cardiff City,Liverpool,3,6,9.5,5.25,1.36,3,6,5,7,14,11,2,3,0,0,27,15,4,6,33.0,67.0,9,9,12,25,5,0,42,10
2192,3871,31,2013/2014,2014-03-22 00:00:00,Chelsea,Arsenal,6,0,1.85,3.6,4.75,9,8,4,3,13,7,0,1,0,1,21,10,7,1,53.0,47.0,6,17,7,20,1,1,31,8
2193,3872,31,2013/2014,2014-03-22 00:00:00,Everton,Swansea City,3,2,1.67,3.9,6.0,3,11,2,4,6,4,0,0,0,0,12,29,5,12,41.0,59.0,5,14,6,10,0,0,41,17
2194,3873,31,2013/2014,2014-03-22 00:00:00,Hull City,West Bromwich Albion,2,0,2.25,3.3,3.6,3,7,5,8,19,13,2,0,0,0,21,30,4,5,43.0,57.0,2,10,13,32,2,0,51,9
2195,3874,31,2013/2014,2014-03-22 00:00:00,Manchester City,Fulham,5,0,1.17,9.0,17.0,10,1,7,4,8,14,0,4,0,1,33,9,13,2,68.0,32.0,5,11,11,22,4,1,42,15
2196,3875,31,2013/2014,2014-03-22 00:00:00,Newcastle United,Crystal Palace,1,0,1.85,3.6,4.75,10,3,11,5,4,8,0,1,0,0,25,14,9,5,73.0,27.0,1,13,16,12,1,0,39,14
2197,3876,31,2013/2014,2014-03-22 00:00:00,Norwich City,Sunderland,2,0,2.2,3.3,3.75,7,6,4,3,17,19,2,5,0,0,23,17,8,5,54.0,46.0,2,13,7,36,7,0,40,13
2198,3878,31,2013/2014,2014-03-22 00:00:00,West Ham United,Manchester United,0,2,4.5,3.6,1.91,5,5,4,6,8,8,2,1,0,0,45,21,12,7,45.0,55.0,2,10,10,16,3,0,66,19
2199,3869,31,2013/2014,2014-03-23 00:00:00,Aston Villa,Stoke City,1,4,2.2,3.3,3.75,4,1,3,4,15,11,5,1,0,0,24,9,5,3,51.0,49.0,5,5,7,26,6,0,33,8
2200,3877,31,2013/2014,2014-03-23 00:00:00,Tottenham Hotspur,Southampton,3,2,2.25,3.4,3.5,4,4,8,6,9,9,1,2,0,0,30,14,7,3,51.0,49.0,5,8,14,18,3,0,44,10
2201,3833,28,2013/2014,2014-03-25 00:00:00,Manchester United,Manchester City,0,3,3.5,3.6,2.15,7,5,2,5,14,10,2,2,0,0,27,17,5,8,52.0,48.0,3,12,7,24,4,0,44,13
2202,3839,29,2013/2014,2014-03-25 00:00:00,Arsenal,Swansea City,2,2,1.57,4.2,6.5,5,2,5,4,11,12,0,1,0,0,39,11,7,0,61.0,39.0,4,7,9,23,1,0,50,7
2203,3845,29,2013/2014,2014-03-25 00:00:00,Newcastle United,Everton,0,3,3.5,3.4,2.25,11,3,7,2,9,9,0,1,0,0,23,12,9,8,55.0,45.0,3,14,9,18,1,0,35,17
2204,3843,29,2013/2014,2014-03-26 00:00:00,Liverpool,Sunderland,2,1,1.17,9.0,19.0,7,5,11,5,5,15,0,2,0,0,16,20,3,4,62.0,38.0,3,12,16,20,2,0,36,7
2205,3848,29,2013/2014,2014-03-26 00:00:00,West Ham United,Hull City,2,1,2.4,3.3,3.3,3,3,4,4,11,8,0,1,0,1,18,25,4,5,45.0,55.0,3,6,8,19,1,1,43,9
2206,3879,32,2013/2014,2014-03-29 00:00:00,Arsenal,Manchester City,1,1,3.6,3.5,2.15,3,8,3,8,8,8,1,4,0,0,27,19,6,6,47.0,53.0,2,11,11,16,5,0,46,12
2207,3880,32,2013/2014,2014-03-29 00:00:00,Crystal Palace,Chelsea,1,0,10.0,4.75,1.4,5,11,10,12,10,6,4,1,0,0,15,39,2,13,33.0,67.0,1,16,22,16,5,0,54,15
2208,3883,32,2013/2014,2014-03-29 00:00:00,Manchester United,Aston Villa,4,1,1.45,4.75,8.0,4,2,1,8,10,17,2,4,0,0,15,23,0,5,55.0,45.0,5,6,9,27,6,0,38,5
2209,3884,32,2013/2014,2014-03-29 00:00:00,Southampton,Newcastle United,4,0,1.75,3.8,5.25,7,5,12,1,5,6,0,1,0,0,16,17,7,5,54.0,46.0,4,12,13,11,1,0,33,12
2210,3885,32,2013/2014,2014-03-29 00:00:00,Stoke City,Hull City,1,0,2.15,3.3,3.9,8,4,6,3,10,8,2,0,0,0,18,12,8,1,56.0,44.0,1,12,9,18,2,0,30,9
2211,3887,32,2013/2014,2014-03-29 00:00:00,Swansea City,Norwich City,3,0,1.73,3.9,5.25,6,6,5,0,15,9,1,2,0,0,24,20,7,4,58.0,42.0,3,12,5,24,3,0,44,11
2212,3888,32,2013/2014,2014-03-29 00:00:00,West Bromwich Albion,Cardiff City,3,3,1.83,3.75,4.75,5,5,5,1,13,13,1,1,0,0,21,13,4,1,42.0,58.0,6,10,6,26,2,0,34,5
2213,3881,32,2013/2014,2014-03-30 00:00:00,Fulham,Everton,1,3,5.0,3.75,1.8,12,9,9,3,8,4,1,2,0,0,28,15,4,6,37.0,63.0,4,21,12,12,3,0,43,10
2214,3882,32,2013/2014,2014-03-30 00:00:00,Liverpool,Tottenham Hotspur,4,0,1.48,4.75,7.5,2,6,6,9,9,9,0,2,0,0,18,14,5,7,59.0,41.0,4,8,15,18,2,0,32,12
2215,3886,32,2013/2014,2014-03-31 00:00:00,Sunderland,West Ham United,1,2,2.3,3.3,3.5,10,5,13,2,11,15,2,4,0,0,27,12,8,3,60.0,40.0,3,15,15,26,6,0,39,11
2216,3889,33,2013/2014,2014-04-05 00:00:00,Aston Villa,Fulham,1,2,2.05,3.5,4.0,4,10,4,3,12,10,3,2,0,0,19,20,2,7,51.0,49.0,3,14,7,22,5,0,39,9
2217,3890,33,2013/2014,2014-04-05 00:00:00,Cardiff City,Crystal Palace,0,3,2.45,3.25,3.25,6,7,8,2,5,12,2,4,0,0,37,9,10,3,66.0,34.0,3,13,10,17,6,0,46,13
2218,3891,33,2013/2014,2014-04-05 00:00:00,Chelsea,Stoke City,3,0,1.29,6.0,13.0,8,3,8,1,8,16,0,0,0,0,21,6,7,3,49.0,51.0,3,11,9,24,0,0,27,10
2219,3893,33,2013/2014,2014-04-05 00:00:00,Hull City,Swansea City,1,0,2.75,3.3,2.8,3,4,5,9,6,19,0,2,0,0,23,21,7,2,44.0,56.0,1,7,14,25,2,0,44,9
2220,3894,33,2013/2014,2014-04-05 00:00:00,Manchester City,Southampton,4,1,1.33,5.75,10.0,4,1,7,3,9,15,3,0,0,0,15,22,5,9,43.0,57.0,5,5,10,24,3,0,37,14
2221,3895,33,2013/2014,2014-04-05 00:00:00,Newcastle United,Manchester United,0,4,4.2,3.7,1.95,6,0,8,6,16,6,1,0,0,0,28,20,4,5,44.0,56.0,4,6,14,22,1,0,48,9
2222,3896,33,2013/2014,2014-04-05 00:00:00,Norwich City,West Bromwich Albion,0,1,2.4,3.3,3.25,4,5,8,2,10,11,1,0,0,0,30,6,7,3,71.0,29.0,1,9,10,21,1,0,36,10
2223,3892,33,2013/2014,2014-04-06 00:00:00,Everton,Arsenal,3,0,2.5,3.4,3.0,11,8,2,6,6,6,1,2,0,0,14,20,3,6,42.0,58.0,3,19,8,12,3,0,34,9
2224,3898,33,2013/2014,2014-04-06 00:00:00,West Ham United,Liverpool,1,2,9.0,5.0,1.4,2,7,6,7,10,9,4,0,0,0,25,11,4,4,35.0,65.0,3,9,13,19,4,0,36,8
2225,3897,33,2013/2014,2014-04-07 00:00:00,Tottenham Hotspur,Sunderland,5,1,1.57,4.2,6.5,14,4,8,3,12,8,0,2,0,0,22,11,8,2,60.0,40.0,6,18,11,20,2,0,33,10
2226,3900,34,2013/2014,2014-04-12 00:00:00,Crystal Palace,Aston Villa,1,0,2.15,3.3,3.9,3,5,9,2,6,12,0,2,0,0,21,21,2,4,44.0,56.0,1,8,11,18,2,0,42,6
2227,3901,34,2013/2014,2014-04-12 00:00:00,Fulham,Norwich City,1,0,2.15,3.5,3.6,5,7,8,8,10,12,1,3,0,0,23,28,8,8,45.0,55.0,1,12,16,22,4,0,51,16
2228,3904,34,2013/2014,2014-04-12 00:00:00,Southampton,Cardiff City,0,1,1.45,4.75,8.0,9,3,12,2,9,7,0,0,0,0,33,11,5,5,67.0,33.0,1,12,14,16,0,0,44,10
2229,3905,34,2013/2014,2014-04-12 00:00:00,Stoke City,Newcastle United,1,0,2.1,3.4,3.9,2,7,6,6,12,11,1,1,0,0,24,25,4,5,49.0,51.0,1,9,12,23,2,0,49,9
2230,3906,34,2013/2014,2014-04-12 00:00:00,Sunderland,Everton,0,1,4.75,3.7,1.83,14,9,8,11,17,15,3,2,0,0,19,22,6,6,47.0,53.0,1,23,19,32,5,0,41,12
2231,3908,34,2013/2014,2014-04-12 00:00:00,West Bromwich Albion,Tottenham Hotspur,3,3,3.1,3.6,2.38,2,9,1,6,11,8,4,2,0,0,13,34,2,2,32.0,68.0,6,11,7,19,6,0,47,4
2232,3902,34,2013/2014,2014-04-13 00:00:00,Liverpool,Manchester City,3,2,2.45,3.7,2.9,1,6,5,3,7,10,1,3,1,0,14,23,7,7,47.0,53.0,5,7,8,17,4,1,37,14
2233,3907,34,2013/2014,2014-04-13 00:00:00,Swansea City,Chelsea,0,1,5.0,3.6,1.83,5,8,3,11,8,13,1,2,0,0,15,25,5,11,38.0,62.0,1,13,14,21,3,0,40,16
2234,3899,34,2013/2014,2014-04-15 00:00:00,Arsenal,West Ham United,3,1,1.4,5.0,9.0,6,3,2,7,15,12,2,2,0,0,17,25,4,3,65.0,35.0,4,9,9,27,4,0,42,7
2235,3815,26,2013/2014,2014-04-16 00:00:00,Everton,Crystal Palace,2,3,1.4,4.75,10.0,4,1,8,5,6,9,1,2,0,0,44,12,13,3,68.0,32.0,5,5,13,15,3,0,56,16
2236,3817,26,2013/2014,2014-04-16 00:00:00,Manchester City,Sunderland,2,2,1.17,9.0,17.0,3,1,12,9,14,11,1,2,0,0,24,21,3,6,57.0,43.0,4,4,21,25,3,0,45,9
2237,3909,35,2013/2014,2014-04-19 00:00:00,Aston Villa,Southampton,0,0,3.4,3.4,2.1,4,4,4,2,9,11,0,2,0,0,20,14,5,3,31.0,69.0,0,8,6,20,2,0,34,8
2238,3910,35,2013/2014,2014-04-19 00:00:00,Cardiff City,Stoke City,1,1,2.38,3.2,3.0,5,6,5,8,6,11,2,3,0,0,18,21,12,7,44.0,56.0,2,11,13,17,5,0,39,19
2239,3911,35,2013/2014,2014-04-19 00:00:00,Chelsea,Sunderland,1,2,1.18,7.0,13.0,23,1,10,4,12,13,1,2,0,0,37,17,10,4,62.0,38.0,3,24,14,25,3,0,54,14
2240,3915,35,2013/2014,2014-04-19 00:00:00,Newcastle United,Swansea City,1,2,2.63,3.3,2.6,5,4,7,4,6,9,2,0,0,0,21,28,2,8,47.0,53.0,3,9,11,15,2,0,49,10
2241,3917,35,2013/2014,2014-04-19 00:00:00,Tottenham Hotspur,Fulham,3,1,1.5,4.2,6.5,4,4,7,4,8,10,0,1,0,0,23,13,4,5,63.0,37.0,4,8,11,18,1,0,36,9
2242,3918,35,2013/2014,2014-04-19 00:00:00,West Ham United,Crystal Palace,0,1,2.2,3.2,3.4,7,8,6,5,7,15,1,1,0,0,42,20,3,11,66.0,34.0,1,15,11,22,2,0,62,14
2243,3912,35,2013/2014,2014-04-20 00:00:00,Everton,Manchester United,2,0,2.4,3.4,2.8,8,7,8,3,9,8,2,2,0,0,11,27,6,5,38.0,62.0,2,15,11,17,4,0,38,11
2244,3913,35,2013/2014,2014-04-20 00:00:00,Hull City,Arsenal,0,3,4.5,3.6,1.8,6,5,6,4,10,6,1,1,0,0,30,8,6,0,42.0,58.0,3,11,10,16,2,0,38,6
2245,3916,35,2013/2014,2014-04-20 00:00:00,Norwich City,Liverpool,2,3,8.5,5.0,1.33,7,4,3,7,16,11,3,2,0,0,33,5,8,3,42.0,58.0,5,11,10,27,5,0,38,11
2246,3914,35,2013/2014,2014-04-21 00:00:00,Manchester City,West Bromwich Albion,3,1,1.2,7.0,11.0,8,4,8,5,9,7,1,1,0,0,19,15,8,2,69.0,31.0,4,12,13,16,2,0,34,10
2247,3921,36,2013/2014,2014-04-26 00:00:00,Fulham,Hull City,2,2,2.3,3.4,3.4,3,2,5,3,8,5,1,3,0,0,25,13,7,2,45.0,55.0,4,5,8,13,4,0,38,9
2248,3923,36,2013/2014,2014-04-26 00:00:00,Manchester United,Norwich City,4,0,1.36,5.25,9.5,12,4,7,6,13,9,1,1,0,0,18,19,5,3,64.0,36.0,4,16,13,22,2,0,37,8
2249,3924,36,2013/2014,2014-04-26 00:00:00,Southampton,Everton,2,0,2.8,3.5,2.6,9,4,4,3,11,8,0,2,0,0,21,23,4,7,51.0,49.0,2,13,7,19,2,0,44,11
2250,3925,36,2013/2014,2014-04-26 00:00:00,Stoke City,Tottenham Hotspur,0,1,3.2,3.4,2.38,7,9,10,4,11,6,2,2,0,0,23,20,4,3,50.0,50.0,1,16,14,17,4,0,43,7
2251,3927,36,2013/2014,2014-04-26 00:00:00,Swansea City,Aston Villa,4,1,1.7,3.75,6.0,5,3,3,4,9,11,1,3,0,0,24,27,9,6,47.0,53.0,5,8,7,20,4,0,51,15
2252,3928,36,2013/2014,2014-04-26 00:00:00,West Bromwich Albion,West Ham United,1,0,1.91,3.75,4.33,10,6,8,5,14,8,0,1,0,0,26,38,7,6,44.0,56.0,1,16,13,22,1,0,64,13
2253,3920,36,2013/2014,2014-04-27 00:00:00,Crystal Palace,Manchester City,0,2,7.5,5.0,1.44,2,5,1,5,10,11,3,1,0,0,19,22,4,8,46.0,54.0,2,7,6,21,4,0,41,12
2254,3922,36,2013/2014,2014-04-27 00:00:00,Liverpool,Chelsea,0,2,1.67,4.2,5.25,18,7,9,2,9,8,0,4,0,0,54,9,14,3,73.0,27.0,2,25,11,17,4,0,63,17
2255,3926,36,2013/2014,2014-04-27 00:00:00,Sunderland,Cardiff City,4,0,1.91,3.75,4.33,7,2,9,4,10,11,5,3,0,1,19,20,11,5,58.0,42.0,4,9,13,21,8,1,39,16
2256,3919,36,2013/2014,2014-04-28 00:00:00,Arsenal,Newcastle United,3,0,1.29,6.0,12.0,5,4,9,4,10,9,3,2,0,0,31,16,14,0,62.0,38.0,3,9,13,19,5,0,47,14
2257,3930,37,2013/2014,2014-05-03 00:00:00,Aston Villa,Hull City,3,1,2.5,3.3,3.1,5,5,5,4,10,8,0,0,0,0,20,23,8,5,46.0,54.0,4,10,9,18,0,0,43,13
2258,3933,37,2013/2014,2014-05-03 00:00:00,Everton,Manchester City,2,3,5.0,4.0,1.75,1,7,4,7,2,13,0,3,0,0,15,12,3,3,59.0,41.0,5,8,11,15,3,0,27,6
2259,3934,37,2013/2014,2014-05-03 00:00:00,Manchester United,Sunderland,0,1,1.36,5.75,8.5,4,1,12,6,11,10,2,1,0,0,44,10,8,0,63.0,37.0,1,5,18,21,3,0,54,8
2260,3935,37,2013/2014,2014-05-03 00:00:00,Newcastle United,Cardiff City,3,0,2.05,3.6,3.8,10,5,11,9,8,6,1,0,0,0,23,23,10,6,54.0,46.0,3,15,20,14,1,0,46,16
2261,3936,37,2013/2014,2014-05-03 00:00:00,Stoke City,Fulham,4,1,2.3,3.6,3.25,10,4,7,3,9,14,0,2,0,0,18,19,3,5,63.0,37.0,5,14,10,23,2,0,37,8
2262,3937,37,2013/2014,2014-05-03 00:00:00,Swansea City,Southampton,0,1,2.5,3.4,3.0,8,9,5,6,11,5,1,1,0,0,13,28,3,5,39.0,61.0,1,17,11,16,2,0,41,8
2263,3938,37,2013/2014,2014-05-03 00:00:00,West Ham United,Tottenham Hotspur,2,0,4.33,3.75,1.91,9,6,7,4,6,16,0,4,0,1,26,21,10,6,49.0,51.0,2,15,11,22,4,1,47,16
2264,3929,37,2013/2014,2014-05-04 00:00:00,Arsenal,West Bromwich Albion,1,0,1.29,6.0,13.0,5,2,8,9,10,6,2,2,0,0,27,25,9,10,61.0,39.0,1,7,17,16,4,0,52,19
2265,3931,37,2013/2014,2014-05-04 00:00:00,Chelsea,Norwich City,0,0,1.2,7.5,17.0,13,2,12,3,10,15,1,3,0,0,32,12,5,2,71.0,29.0,0,15,15,25,4,0,44,7
2266,3932,37,2013/2014,2014-05-05 00:00:00,Crystal Palace,Liverpool,3,3,9.0,5.0,1.4,4,11,4,11,6,10,2,3,0,0,21,14,7,7,34.0,66.0,6,15,15,16,5,0,35,14
2267,3903,34,2013/2014,2014-05-06 00:00:00,Manchester United,Hull City,3,1,1.36,5.5,9.0,9,1,6,0,12,9,1,1,0,0,20,10,7,0,55.0,45.0,4,10,6,21,2,0,30,7
2268,3836,28,2013/2014,2014-05-07 00:00:00,Sunderland,West Bromwich Albion,2,0,2.1,3.2,4.2,4,8,3,5,14,11,0,0,0,0,16,17,5,0,49.0,51.0,2,12,8,25,0,0,33,5
2269,3844,29,2013/2014,2014-05-07 00:00:00,Manchester City,Aston Villa,4,0,1.14,9.5,21.0,9,1,5,3,8,9,1,2,0,0,29,8,7,2,75.0,25.0,4,10,8,17,3,0,37,9
2270,3939,38,2013/2014,2014-05-11 00:00:00,Cardiff City,Chelsea,1,2,8.0,4.75,1.44,5,12,4,13,7,9,1,2,0,0,13,29,3,8,37.0,63.0,3,17,17,16,3,0,42,11
2271,3940,38,2013/2014,2014-05-11 00:00:00,Fulham,Crystal Palace,2,2,2.63,3.5,2.8,6,7,7,4,10,11,3,2,0,0,21,10,6,4,66.0,34.0,4,13,11,21,5,0,31,10
2272,3941,38,2013/2014,2014-05-11 00:00:00,Hull City,Everton,0,2,4.0,3.6,2.0,7,3,6,5,8,8,0,1,0,0,16,13,6,4,42.0,58.0,2,10,11,16,1,0,29,10
2273,3942,38,2013/2014,2014-05-11 00:00:00,Liverpool,Newcastle United,2,1,1.22,7.5,13.0,9,3,5,4,8,16,1,4,0,1,20,11,6,2,64.0,36.0,3,12,9,24,5,1,31,8
2274,3943,38,2013/2014,2014-05-11 00:00:00,Manchester City,West Ham United,2,0,1.17,9.0,17.0,14,0,11,3,7,9,2,2,0,0,22,16,12,1,68.0,32.0,2,14,14,16,4,0,38,13
2275,3944,38,2013/2014,2014-05-11 00:00:00,Norwich City,Arsenal,0,2,4.5,3.8,1.85,5,8,4,5,6,5,1,0,0,0,18,17,4,4,35.0,65.0,2,13,9,11,1,0,35,8
2276,3945,38,2013/2014,2014-05-11 00:00:00,Southampton,Manchester United,1,1,2.63,3.5,2.8,5,0,4,6,15,5,3,2,0,0,17,17,6,2,64.0,36.0,2,5,10,20,5,0,34,8
2277,3946,38,2013/2014,2014-05-11 00:00:00,Sunderland,Swansea City,1,3,2.3,3.4,3.4,7,2,10,1,13,15,2,3,0,0,25,12,6,3,56.0,44.0,4,9,11,28,5,0,37,9
2278,3947,38,2013/2014,2014-05-11 00:00:00,Tottenham Hotspur,Aston Villa,3,0,1.5,4.5,7.5,8,2,4,3,10,10,1,0,0,0,14,13,5,1,54.0,46.0,3,10,7,20,1,0,27,6
2279,3948,38,2013/2014,2014-05-11 00:00:00,West Bromwich Albion,Stoke City,1,2,2.1,3.6,3.75,11,7,7,7,5,7,0,0,0,0,24,10,11,6,42.0,58.0,3,18,14,12,0,0,34,17
2280,4009,1,2014/2015,2014-08-16 00:00:00,Arsenal,Crystal Palace,2,1,1.25,6.5,15.0,7,3,5,0,12,19,2,3,0,0,32,9,9,3,77.0,23.0,3,10,5,31,5,0,41,12
2281,4011,1,2014/2015,2014-08-16 00:00:00,Leicester City,Everton,2,2,3.2,3.4,2.4,2,7,6,4,16,10,1,1,0,0,18,12,3,6,36.0,64.0,4,9,10,26,2,0,30,9
2282,4013,1,2014/2015,2014-08-16 00:00:00,Manchester United,Swansea City,1,2,1.36,5.0,11.0,8,3,5,1,14,20,2,4,0,0,28,5,4,0,58.0,42.0,3,11,6,34,6,0,33,4
2283,4015,1,2014/2015,2014-08-16 00:00:00,Queens Park Rangers,Hull City,0,1,2.5,3.3,3.1,11,5,4,2,9,10,1,2,0,0,32,21,8,9,51.0,49.0,1,16,6,19,3,0,53,17
2284,4016,1,2014/2015,2014-08-16 00:00:00,Stoke City,Aston Villa,0,1,1.95,3.5,4.5,5,2,6,5,10,6,0,3,0,0,21,24,2,8,65.0,35.0,1,7,11,16,3,0,45,10
2285,4017,1,2014/2015,2014-08-16 00:00:00,West Bromwich Albion,Sunderland,2,2,2.25,3.4,3.5,4,0,5,3,16,6,3,1,0,0,20,11,6,3,57.0,43.0,4,4,8,22,4,0,31,9
2286,4018,1,2014/2015,2014-08-16 00:00:00,West Ham United,Tottenham Hotspur,0,1,3.8,3.6,2.05,6,4,7,2,13,11,2,0,0,1,26,10,8,5,47.0,53.0,1,10,9,24,2,1,36,13
2287,4012,1,2014/2015,2014-08-17 00:00:00,Liverpool,Southampton,2,1,1.33,5.75,10.0,4,5,5,4,8,14,1,2,0,0,13,31,2,6,56.0,44.0,3,9,9,22,3,0,44,8
2288,4014,1,2014/2015,2014-08-17 00:00:00,Newcastle United,Manchester City,0,2,5.25,4.33,1.67,5,7,8,4,8,11,1,5,0,0,21,13,3,3,45.0,55.0,2,12,12,19,6,0,34,6
2289,4010,1,2014/2015,2014-08-18 00:00:00,Burnley,Chelsea,1,3,9.0,5.0,1.4,1,3,4,4,6,7,1,1,0,0,21,15,4,3,38.0,62.0,4,4,8,13,2,0,36,7
2290,4119,2,2014/2015,2014-08-23 00:00:00,Aston Villa,Newcastle United,0,0,2.5,3.4,3.0,4,4,5,7,11,8,4,1,0,0,26,24,7,7,40.0,60.0,0,8,12,19,5,0,50,14
2291,4120,2,2014/2015,2014-08-23 00:00:00,Chelsea,Leicester City,2,0,1.2,7.5,17.0,14,5,10,1,10,11,0,1,0,0,27,25,8,7,63.0,37.0,2,19,11,21,1,0,52,15
2292,4121,2,2014/2015,2014-08-23 00:00:00,Crystal Palace,West Ham United,1,3,2.5,3.3,3.1,7,7,2,4,11,10,1,3,0,0,16,17,6,9,45.0,55.0,4,14,6,21,4,0,33,15
2293,4122,2,2014/2015,2014-08-23 00:00:00,Everton,Arsenal,2,2,2.8,3.4,2.7,2,4,4,6,10,18,1,4,0,0,8,17,3,3,45.0,55.0,4,6,10,28,5,0,25,6
2294,4125,2,2014/2015,2014-08-23 00:00:00,Southampton,West Bromwich Albion,0,0,1.85,3.7,4.75,3,3,5,4,14,16,1,2,0,0,20,20,1,5,59.0,41.0,0,6,9,30,3,0,40,6
2295,4127,2,2014/2015,2014-08-23 00:00:00,Swansea City,Burnley,1,0,1.65,4.0,6.0,6,7,2,6,13,12,2,1,0,0,16,21,2,3,57.0,43.0,1,13,8,25,3,0,37,5
2296,4123,2,2014/2015,2014-08-24 00:00:00,Hull City,Stoke City,1,1,2.5,3.25,3.2,5,4,2,10,10,10,1,3,1,0,12,24,4,5,43.0,57.0,2,9,12,20,4,1,36,9
2297,4126,2,2014/2015,2014-08-24 00:00:00,Sunderland,Manchester United,1,1,5.0,4.0,1.75,4,4,6,4,10,15,0,2,0,0,17,18,4,4,45.0,55.0,2,8,10,25,2,0,35,8
2298,4128,2,2014/2015,2014-08-24 00:00:00,Tottenham Hotspur,Queens Park Rangers,4,0,1.45,4.75,8.0,6,1,8,7,10,6,0,1,0,0,24,22,7,6,66.0,34.0,4,7,15,16,1,0,46,13
2299,4124,2,2014/2015,2014-08-25 00:00:00,Manchester City,Liverpool,3,1,1.85,4.0,4.33,1,6,4,5,13,7,1,1,0,0,10,22,6,7,50.0,50.0,4,7,9,20,2,0,32,13
2300,4230,3,2014/2015,2014-08-30 00:00:00,Burnley,Manchester United,0,0,6.0,4.2,1.62,4,4,5,4,10,15,2,2,0,0,11,25,3,6,37.0,63.0,0,8,9,25,4,0,36,9
2301,4231,3,2014/2015,2014-08-30 00:00:00,Everton,Chelsea,3,6,3.75,3.3,2.2,10,5,4,1,7,17,1,3,0,0,30,9,8,2,61.0,39.0,9,15,5,24,4,0,39,10
2302,4233,3,2014/2015,2014-08-30 00:00:00,Manchester City,Stoke City,0,1,1.18,8.0,18.0,11,2,6,4,13,5,2,1,0,0,28,17,11,4,73.0,27.0,1,13,10,18,3,0,45,15
2303,4234,3,2014/2015,2014-08-30 00:00:00,Newcastle United,Crystal Palace,3,3,1.75,3.75,5.25,4,5,11,4,12,19,1,3,0,0,28,12,11,4,67.0,33.0,6,9,15,31,4,0,40,15
2304,4235,3,2014/2015,2014-08-30 00:00:00,Queens Park Rangers,Sunderland,1,0,2.4,3.25,3.3,5,8,10,7,9,9,1,2,0,0,15,24,4,6,39.0,61.0,1,13,17,18,3,0,39,10
2305,4236,3,2014/2015,2014-08-30 00:00:00,Swansea City,West Bromwich Albion,3,0,1.85,3.6,4.75,6,7,6,10,10,9,1,2,0,0,12,23,0,7,55.0,45.0,3,13,16,19,3,0,35,7
2306,4238,3,2014/2015,2014-08-30 00:00:00,West Ham United,Southampton,1,3,2.8,3.4,2.7,2,9,1,5,10,13,2,1,0,0,15,28,2,9,37.0,63.0,4,11,6,23,3,0,43,11
2307,4229,3,2014/2015,2014-08-31 00:00:00,Aston Villa,Hull City,2,1,2.3,3.3,3.5,2,2,6,5,8,10,1,4,0,0,12,29,3,7,45.0,55.0,3,4,11,18,5,0,41,10
2308,4232,3,2014/2015,2014-08-31 00:00:00,Leicester City,Arsenal,1,1,4.75,3.75,1.83,5,16,4,7,11,5,3,1,0,0,21,36,5,10,30.0,70.0,2,21,11,16,4,0,57,15
2309,4237,3,2014/2015,2014-08-31 00:00:00,Tottenham Hotspur,Liverpool,0,3,2.7,3.5,2.7,3,6,4,8,14,13,0,4,0,0,23,8,7,3,59.0,41.0,3,9,12,27,4,0,31,10
2310,4329,4,2014/2015,2014-09-13 00:00:00,Arsenal,Manchester City,2,2,3.0,3.4,2.5,4,8,9,5,8,15,3,4,0,0,22,16,0,3,46.0,54.0,4,12,14,23,7,0,38,3
2311,4330,4,2014/2015,2014-09-13 00:00:00,Chelsea,Swansea City,4,2,1.3,5.75,12.0,13,3,9,8,12,11,0,3,0,0,20,11,7,4,52.0,48.0,6,16,17,23,3,0,31,11
2312,4331,4,2014/2015,2014-09-13 00:00:00,Crystal Palace,Burnley,0,0,2.25,3.3,3.6,3,7,11,4,12,10,2,3,0,0,17,12,5,6,45.0,55.0,0,10,15,22,5,0,29,11
2313,4333,4,2014/2015,2014-09-13 00:00:00,Liverpool,Aston Villa,0,1,1.3,6.0,11.0,6,2,11,3,9,10,2,1,0,0,21,11,7,6,72.0,28.0,1,8,14,19,3,0,32,13
2314,4335,4,2014/2015,2014-09-13 00:00:00,Southampton,Newcastle United,4,0,1.8,3.75,5.0,3,4,2,4,13,7,0,2,0,0,13,13,5,5,47.0,53.0,4,7,6,20,2,0,26,10
2315,4336,4,2014/2015,2014-09-13 00:00:00,Stoke City,Leicester City,0,1,2.1,3.4,4.0,9,0,16,4,9,15,3,0,0,0,28,9,16,3,59.0,41.0,1,9,20,24,3,0,37,19
2316,4337,4,2014/2015,2014-09-13 00:00:00,Sunderland,Tottenham Hotspur,2,2,3.6,3.5,2.15,3,10,3,4,16,14,5,1,0,0,18,14,6,5,37.0,63.0,4,13,7,30,6,0,32,11
2317,4338,4,2014/2015,2014-09-13 00:00:00,West Bromwich Albion,Everton,0,2,3.5,3.5,2.2,8,4,5,6,8,5,2,3,0,0,17,7,9,1,46.0,54.0,2,12,11,13,5,0,24,10
2318,4334,4,2014/2015,2014-09-14 00:00:00,Manchester United,Queens Park Rangers,4,0,1.29,6.25,12.0,8,4,6,3,11,8,1,0,0,0,17,6,3,1,69.0,31.0,4,12,9,19,1,0,23,4
2319,4332,4,2014/2015,2014-09-15 00:00:00,Hull City,West Ham United,2,2,2.15,3.4,3.75,6,11,4,6,12,8,3,1,0,0,20,20,3,10,40.0,60.0,4,17,10,20,4,0,40,13
2320,4339,5,2014/2015,2014-09-20 00:00:00,Aston Villa,Arsenal,0,3,4.75,3.6,1.85,4,4,1,4,12,10,1,3,0,0,13,13,5,5,28.0,72.0,3,8,5,22,4,0,26,10
2321,4340,5,2014/2015,2014-09-20 00:00:00,Burnley,Sunderland,0,0,2.5,3.3,3.1,5,7,5,5,14,14,1,2,0,0,17,13,5,1,43.0,57.0,0,12,10,28,3,0,30,6
2322,4344,5,2014/2015,2014-09-20 00:00:00,Newcastle United,Hull City,2,2,2.2,3.3,3.75,12,2,7,5,12,10,4,2,0,0,24,11,4,2,63.0,37.0,4,14,12,22,6,0,35,6
2323,4345,5,2014/2015,2014-09-20 00:00:00,Queens Park Rangers,Stoke City,2,2,2.8,3.25,2.8,9,3,11,4,6,15,2,4,0,0,19,12,10,1,55.0,45.0,4,12,15,21,6,0,31,11
2324,4346,5,2014/2015,2014-09-20 00:00:00,Swansea City,Southampton,0,1,2.5,3.3,3.1,2,3,3,6,11,15,1,4,0,0,6,11,2,4,46.0,54.0,1,5,9,26,5,0,17,6
2325,4348,5,2014/2015,2014-09-20 00:00:00,West Ham United,Liverpool,3,1,4.5,3.8,1.85,8,7,3,3,17,11,4,1,0,0,11,16,7,5,36.0,64.0,4,15,6,28,5,0,27,12
2326,4341,5,2014/2015,2014-09-21 00:00:00,Everton,Crystal Palace,2,3,1.4,5.0,9.0,6,4,7,3,8,10,2,1,0,0,16,12,7,1,76.0,24.0,5,10,10,18,3,0,28,8
2327,4342,5,2014/2015,2014-09-21 00:00:00,Leicester City,Manchester United,5,3,5.5,4.2,1.67,2,5,5,9,11,11,1,1,0,1,19,17,2,4,41.0,59.0,8,7,14,22,2,1,36,6
2328,4343,5,2014/2015,2014-09-21 00:00:00,Manchester City,Chelsea,1,1,2.38,3.5,3.1,6,3,9,2,16,12,4,4,0,0,25,10,14,2,60.0,40.0,2,9,11,28,8,0,35,16
2329,4347,5,2014/2015,2014-09-21 00:00:00,Tottenham Hotspur,West Bromwich Albion,0,1,1.53,4.33,7.0,3,5,3,4,12,7,2,2,0,0,29,10,9,7,62.0,38.0,1,8,7,19,4,0,39,16
2330,4349,6,2014/2015,2014-09-27 00:00:00,Arsenal,Tottenham Hotspur,1,1,1.75,3.9,5.0,15,6,2,1,8,14,3,6,0,0,30,6,15,5,69.0,31.0,2,21,3,22,9,0,36,20
2331,4350,6,2014/2015,2014-09-27 00:00:00,Chelsea,Aston Villa,3,0,1.22,7.0,16.0,8,2,8,4,11,9,2,2,0,0,17,12,9,2,62.0,38.0,3,10,12,20,4,0,29,11
2332,4351,6,2014/2015,2014-09-27 00:00:00,Crystal Palace,Leicester City,2,0,2.63,3.4,2.88,7,4,5,2,10,7,0,2,0,0,15,24,6,6,39.0,61.0,2,11,7,17,2,0,39,12
2333,4352,6,2014/2015,2014-09-27 00:00:00,Hull City,Manchester City,2,4,6.5,4.2,1.57,4,7,4,8,10,6,0,2,0,0,23,8,3,8,41.0,59.0,6,11,12,16,2,0,31,11
2334,4353,6,2014/2015,2014-09-27 00:00:00,Liverpool,Everton,1,1,1.91,3.75,4.33,14,6,8,3,8,9,2,1,0,0,14,7,8,2,48.0,52.0,2,20,11,17,3,0,21,10
2335,4354,6,2014/2015,2014-09-27 00:00:00,Manchester United,West Ham United,2,1,1.4,5.5,8.0,3,1,3,6,10,12,1,3,1,0,12,24,7,10,58.0,42.0,3,4,9,22,4,1,36,17
2336,4355,6,2014/2015,2014-09-27 00:00:00,Southampton,Queens Park Rangers,2,1,1.44,4.6,8.5,7,0,8,7,12,11,2,1,0,0,13,8,6,3,56.0,44.0,3,7,15,23,3,0,21,9
2337,4357,6,2014/2015,2014-09-27 00:00:00,Sunderland,Swansea City,0,0,2.9,3.3,2.63,5,1,10,6,14,16,2,2,0,0,23,11,10,1,48.0,52.0,0,6,16,30,4,0,34,11
2338,4358,6,2014/2015,2014-09-28 00:00:00,West Bromwich Albion,Burnley,4,0,2.0,3.5,4.2,10,7,7,4,6,9,1,2,0,0,19,16,10,2,62.0,38.0,4,17,11,15,3,0,35,12
2339,4356,6,2014/2015,2014-09-29 00:00:00,Stoke City,Newcastle United,1,0,2.15,3.4,3.8,6,4,4,11,20,15,1,2,0,0,8,20,2,10,44.0,56.0,1,10,15,35,3,0,28,12
2340,4359,7,2014/2015,2014-10-04 00:00:00,Aston Villa,Manchester City,0,2,7.5,4.5,1.5,3,14,5,11,4,6,0,1,0,0,7,23,0,7,33.0,67.0,2,17,16,10,1,0,30,7
2341,4361,7,2014/2015,2014-10-04 00:00:00,Hull City,Crystal Palace,2,0,2.1,3.5,3.8,7,5,7,5,6,13,1,2,0,0,14,13,6,7,60.0,40.0,2,12,12,19,3,0,27,13
2342,4362,7,2014/2015,2014-10-04 00:00:00,Leicester City,Burnley,2,2,1.8,3.75,5.0,10,3,5,6,16,13,2,2,0,0,23,25,9,3,53.0,47.0,4,13,11,29,4,0,48,12
2343,4363,7,2014/2015,2014-10-04 00:00:00,Liverpool,West Bromwich Albion,2,1,1.44,5.0,7.5,11,3,5,4,12,16,2,2,0,0,14,14,5,5,55.0,45.0,3,14,9,28,4,0,28,10
2344,4365,7,2014/2015,2014-10-04 00:00:00,Sunderland,Stoke City,3,1,2.55,3.25,3.1,2,5,3,4,11,17,3,4,0,0,12,14,7,4,40.0,60.0,4,7,7,28,7,0,26,11
2345,4366,7,2014/2015,2014-10-04 00:00:00,Swansea City,Newcastle United,2,2,1.91,3.7,4.33,4,3,5,3,11,15,1,3,0,0,11,21,3,1,64.0,36.0,4,7,8,26,4,0,32,4
2346,4360,7,2014/2015,2014-10-05 00:00:00,Chelsea,Arsenal,2,0,1.67,4.2,5.25,3,3,2,6,14,10,4,3,0,0,11,14,2,2,47.0,53.0,2,6,8,24,7,0,25,4
2347,4364,7,2014/2015,2014-10-05 00:00:00,Manchester United,Everton,2,1,1.67,4.2,5.25,4,6,8,2,18,12,4,3,0,0,19,16,11,6,53.0,47.0,3,10,10,30,7,0,35,17
2348,4367,7,2014/2015,2014-10-05 00:00:00,Tottenham Hotspur,Southampton,1,0,2.2,3.5,3.5,5,5,2,4,15,9,2,1,0,0,13,12,10,5,45.0,55.0,1,10,6,24,3,0,25,15
2349,4368,7,2014/2015,2014-10-05 00:00:00,West Ham United,Queens Park Rangers,2,0,1.91,3.6,4.5,5,5,4,3,10,12,2,2,0,0,18,9,7,5,49.0,51.0,2,10,7,22,4,0,27,12
2350,4369,8,2014/2015,2014-10-18 00:00:00,Arsenal,Hull City,2,2,1.4,5.0,9.0,13,3,7,0,7,13,2,2,0,0,15,4,10,0,69.0,31.0,4,16,7,20,4,0,19,10
2351,4370,8,2014/2015,2014-10-18 00:00:00,Burnley,West Ham United,1,3,2.8,3.4,2.7,2,2,9,6,3,10,0,1,0,0,13,11,5,7,45.0,55.0,4,4,15,13,1,0,24,12
2352,4371,8,2014/2015,2014-10-18 00:00:00,Crystal Palace,Chelsea,1,2,8.5,4.75,1.44,3,5,3,7,13,7,2,1,0,1,10,6,3,2,29.0,71.0,3,8,10,20,3,1,16,5
2353,4372,8,2014/2015,2014-10-18 00:00:00,Everton,Aston Villa,3,0,1.6,4.0,6.5,10,6,2,4,12,16,2,2,0,0,7,20,3,4,60.0,40.0,3,16,6,28,4,0,27,7
2354,4373,8,2014/2015,2014-10-18 00:00:00,Manchester City,Tottenham Hotspur,4,1,1.45,4.75,8.0,11,12,5,6,11,10,1,2,0,1,10,7,3,4,62.0,38.0,5,23,11,21,3,1,17,7
2355,4374,8,2014/2015,2014-10-18 00:00:00,Newcastle United,Leicester City,1,0,2.25,3.6,3.3,9,4,7,2,13,17,0,3,0,0,17,17,10,7,50.0,50.0,1,13,9,30,3,0,34,17
2356,4376,8,2014/2015,2014-10-18 00:00:00,Southampton,Sunderland,8,0,1.57,4.0,7.0,4,3,7,5,11,8,1,3,0,0,18,13,5,6,51.0,49.0,8,7,12,19,4,0,31,11
2357,4375,8,2014/2015,2014-10-19 00:00:00,Queens Park Rangers,Liverpool,2,3,6.0,4.2,1.6,9,6,5,7,11,15,2,3,0,0,18,9,7,2,44.0,56.0,5,15,12,26,5,0,27,9
2358,4377,8,2014/2015,2014-10-19 00:00:00,Stoke City,Swansea City,2,1,2.5,3.3,3.1,6,7,8,3,17,7,4,1,0,0,14,8,3,5,43.0,57.0,3,13,11,24,5,0,22,8
2359,4378,8,2014/2015,2014-10-20 00:00:00,West Bromwich Albion,Manchester United,2,2,5.0,4.0,1.75,2,11,3,8,6,8,1,2,0,0,10,33,0,11,37.0,63.0,4,13,11,14,3,0,43,11
2360,4380,9,2014/2015,2014-10-25 00:00:00,Liverpool,Hull City,0,0,1.44,4.75,8.0,14,3,6,2,10,17,3,2,0,0,24,11,14,1,66.0,34.0,0,17,8,27,5,0,35,15
2361,4383,9,2014/2015,2014-10-25 00:00:00,Southampton,Stoke City,1,0,1.65,4.0,6.0,5,2,12,2,10,13,0,2,0,0,14,7,6,3,62.0,38.0,1,7,14,23,2,0,21,9
2362,4384,9,2014/2015,2014-10-25 00:00:00,Sunderland,Arsenal,0,2,5.5,3.8,1.73,4,5,3,9,9,8,3,3,0,0,14,21,3,3,39.0,61.0,2,9,12,17,6,0,35,6
2363,4385,9,2014/2015,2014-10-25 00:00:00,Swansea City,Leicester City,2,0,1.95,3.7,4.2,2,4,5,4,7,11,0,0,0,0,10,10,2,2,49.0,51.0,2,6,9,18,0,0,20,4
2364,4387,9,2014/2015,2014-10-25 00:00:00,West Bromwich Albion,Crystal Palace,2,2,1.91,3.6,4.5,7,7,8,2,14,8,3,1,0,0,27,7,6,3,69.0,31.0,4,14,10,22,4,0,34,9
2365,4388,9,2014/2015,2014-10-25 00:00:00,West Ham United,Manchester City,2,1,6.5,4.5,1.55,4,9,6,13,12,14,2,1,0,0,26,17,4,8,31.0,69.0,3,13,19,26,3,0,43,12
2366,4379,9,2014/2015,2014-10-26 00:00:00,Burnley,Everton,1,3,4.75,3.75,1.83,7,8,7,4,11,7,4,2,0,0,32,8,5,4,38.0,62.0,4,15,11,18,6,0,40,9
2367,4381,9,2014/2015,2014-10-26 00:00:00,Manchester United,Chelsea,1,1,2.88,3.6,2.5,6,3,9,4,12,14,3,6,0,0,27,10,4,7,52.0,48.0,2,9,13,26,9,0,37,11
2368,4386,9,2014/2015,2014-10-26 00:00:00,Tottenham Hotspur,Newcastle United,1,2,1.75,3.9,5.0,8,2,9,4,9,12,2,3,0,0,29,11,10,2,68.0,32.0,3,10,13,21,5,0,40,12
2369,4382,9,2014/2015,2014-10-27 00:00:00,Queens Park Rangers,Aston Villa,2,0,2.38,3.25,3.4,3,10,3,6,11,15,0,2,0,0,11,23,2,4,35.0,65.0,2,13,9,26,2,0,34,6
2370,4019,10,2014/2015,2014-11-01 00:00:00,Arsenal,Burnley,3,0,1.25,6.5,14.0,18,3,11,1,5,6,0,1,0,0,28,3,18,1,69.0,31.0,3,21,12,11,1,0,31,19
2371,4021,10,2014/2015,2014-11-01 00:00:00,Chelsea,Queens Park Rangers,2,1,1.17,8.5,21.0,9,5,9,3,8,12,0,0,0,0,19,8,13,2,65.0,35.0,3,14,12,20,0,0,27,15
2372,4023,10,2014/2015,2014-11-01 00:00:00,Everton,Swansea City,0,0,1.75,3.8,5.25,7,4,7,4,10,15,2,4,0,0,20,10,12,0,67.0,33.0,0,11,11,25,6,0,30,12
2373,4024,10,2014/2015,2014-11-01 00:00:00,Hull City,Southampton,0,1,3.8,3.6,2.05,3,3,5,6,6,9,1,0,0,0,16,6,7,4,46.0,54.0,1,6,11,15,1,0,22,11
2374,4025,10,2014/2015,2014-11-01 00:00:00,Leicester City,West Bromwich Albion,0,1,2.3,3.5,3.3,7,6,8,1,5,12,0,1,0,0,21,5,8,3,58.0,42.0,1,13,9,17,1,0,26,11
2375,4027,10,2014/2015,2014-11-01 00:00:00,Newcastle United,Liverpool,1,0,3.8,3.75,2.0,7,4,4,2,13,8,4,3,0,0,17,19,7,2,35.0,65.0,1,11,6,21,7,0,36,9
2376,4028,10,2014/2015,2014-11-01 00:00:00,Stoke City,West Ham United,2,2,2.38,3.4,3.25,9,5,9,4,11,17,1,1,0,0,32,11,9,2,60.0,40.0,4,14,13,28,2,0,43,11
2377,4020,10,2014/2015,2014-11-02 00:00:00,Aston Villa,Tottenham Hotspur,1,2,3.75,3.6,2.1,4,12,7,5,12,11,3,3,1,0,26,24,3,9,39.0,61.0,3,16,12,23,6,1,50,12
2378,4026,10,2014/2015,2014-11-02 00:00:00,Manchester City,Manchester United,1,0,1.91,3.75,4.33,8,3,5,6,17,10,3,2,0,0,14,13,7,4,52.0,48.0,1,11,11,27,5,0,27,11
2379,4022,10,2014/2015,2014-11-03 00:00:00,Crystal Palace,Sunderland,1,3,2.1,3.5,3.8,8,5,2,0,12,20,1,3,0,0,21,7,11,2,53.0,47.0,4,13,2,32,4,0,28,13
2380,4029,11,2014/2015,2014-11-08 00:00:00,Burnley,Hull City,1,0,2.5,3.4,3.0,10,2,3,7,17,17,6,4,0,0,10,12,7,1,54.0,46.0,1,12,10,34,10,0,22,8
2381,4030,11,2014/2015,2014-11-08 00:00:00,Liverpool,Chelsea,1,2,3.4,3.4,2.3,7,9,4,6,9,12,2,5,0,0,26,12,5,7,59.0,41.0,3,16,10,21,7,0,38,12
2382,4031,11,2014/2015,2014-11-08 00:00:00,Manchester United,Crystal Palace,1,0,1.3,6.0,11.0,9,2,9,5,8,12,1,3,0,0,15,11,11,4,72.0,28.0,1,11,14,20,4,0,26,15
2383,4032,11,2014/2015,2014-11-08 00:00:00,Queens Park Rangers,Manchester City,2,2,7.0,4.75,1.5,10,13,3,8,9,10,4,2,0,0,27,18,7,7,43.0,57.0,4,23,11,19,6,0,45,14
2384,4033,11,2014/2015,2014-11-08 00:00:00,Southampton,Leicester City,2,0,1.44,4.75,8.0,8,1,6,4,10,12,2,2,0,0,27,15,13,4,65.0,35.0,2,9,10,22,4,0,42,17
2385,4038,11,2014/2015,2014-11-08 00:00:00,West Ham United,Aston Villa,0,0,1.75,3.75,5.5,14,6,8,5,9,10,0,3,0,0,40,15,13,2,57.0,43.0,0,20,13,19,3,0,55,15
2386,4034,11,2014/2015,2014-11-09 00:00:00,Sunderland,Everton,1,1,4.0,3.5,2.05,5,8,4,8,11,12,1,2,0,0,22,13,5,4,42.0,58.0,2,13,12,23,3,0,35,9
2387,4035,11,2014/2015,2014-11-09 00:00:00,Swansea City,Arsenal,2,1,3.75,3.5,2.1,5,6,3,5,10,16,5,5,0,0,18,19,6,10,48.0,52.0,3,11,8,26,10,0,37,16
2388,4036,11,2014/2015,2014-11-09 00:00:00,Tottenham Hotspur,Stoke City,1,2,1.7,4.0,5.5,6,5,7,6,20,13,3,2,1,0,17,9,5,5,60.0,40.0,3,11,13,33,5,1,26,10
2389,4037,11,2014/2015,2014-11-09 00:00:00,West Bromwich Albion,Newcastle United,0,2,2.3,3.5,3.3,4,1,5,3,12,6,0,0,0,0,9,17,7,4,57.0,43.0,2,5,8,18,0,0,26,11
2390,4039,12,2014/2015,2014-11-22 00:00:00,Arsenal,Manchester United,1,2,2.15,3.6,3.5,13,1,8,8,12,9,2,1,0,0,15,8,11,5,62.0,38.0,3,14,16,21,3,0,23,16
2391,4041,12,2014/2015,2014-11-22 00:00:00,Chelsea,West Bromwich Albion,2,0,1.25,6.5,15.0,12,1,7,3,7,9,1,0,0,1,26,6,15,0,76.0,24.0,2,13,10,16,1,1,32,15
2392,4043,12,2014/2015,2014-11-22 00:00:00,Everton,West Ham United,2,1,1.85,3.8,4.5,5,6,6,7,10,13,2,3,0,0,3,23,1,5,56.0,44.0,3,11,13,23,5,0,26,6
2393,4045,12,2014/2015,2014-11-22 00:00:00,Leicester City,Sunderland,0,0,2.1,3.5,3.8,6,8,9,3,18,11,2,3,0,0,21,23,6,9,40.0,60.0,0,14,12,29,5,0,44,15
2394,4046,12,2014/2015,2014-11-22 00:00:00,Manchester City,Swansea City,2,1,1.4,5.25,8.5,11,3,9,4,11,7,2,1,0,0,18,7,7,3,59.0,41.0,3,14,13,18,3,0,25,10
2395,4047,12,2014/2015,2014-11-22 00:00:00,Newcastle United,Queens Park Rangers,1,0,1.83,3.75,4.75,10,9,3,4,12,15,2,3,0,0,18,11,16,7,56.0,44.0,1,19,7,27,5,0,29,23
2396,4048,12,2014/2015,2014-11-22 00:00:00,Stoke City,Burnley,1,2,1.7,3.8,5.75,6,2,11,1,9,9,2,2,0,0,30,4,14,0,72.0,28.0,3,8,12,18,4,0,34,14
2397,4042,12,2014/2015,2014-11-23 00:00:00,Crystal Palace,Liverpool,3,1,4.33,3.7,1.91,7,5,4,9,21,10,1,2,0,0,22,13,4,3,35.0,65.0,4,12,13,31,3,0,35,7
2398,4044,12,2014/2015,2014-11-23 00:00:00,Hull City,Tottenham Hotspur,1,2,3.6,3.4,2.2,2,12,6,10,14,9,3,1,1,0,16,25,3,9,26.0,74.0,3,14,16,23,4,1,41,12
2399,4040,12,2014/2015,2014-11-24 00:00:00,Aston Villa,Southampton,1,1,5.25,3.75,1.75,4,9,2,7,15,17,1,2,0,0,16,27,2,8,36.0,64.0,2,13,9,32,3,0,43,10
2400,4049,13,2014/2015,2014-11-29 00:00:00,Burnley,Aston Villa,1,1,2.15,3.4,3.75,7,14,6,4,8,8,3,4,0,0,19,16,1,5,47.0,53.0,2,21,10,16,7,0,35,6
2401,4050,13,2014/2015,2014-11-29 00:00:00,Liverpool,Stoke City,1,0,1.73,4.0,5.0,7,10,8,6,12,9,0,3,0,0,17,9,5,5,48.0,52.0,1,17,14,21,3,0,26,10
2402,4051,13,2014/2015,2014-11-29 00:00:00,Manchester United,Hull City,3,0,1.33,5.75,10.0,5,3,7,1,12,12,2,2,0,0,15,7,7,0,77.0,23.0,3,8,8,24,4,0,22,7
2403,4052,13,2014/2015,2014-11-29 00:00:00,Queens Park Rangers,Leicester City,3,2,2.38,3.4,3.25,8,3,16,9,8,17,3,2,0,0,20,14,11,5,62.0,38.0,5,11,25,25,5,0,34,16
2404,4054,13,2014/2015,2014-11-29 00:00:00,Sunderland,Chelsea,0,0,9.0,5.0,1.4,9,15,5,9,13,10,3,2,0,0,15,14,2,8,34.0,66.0,0,24,14,23,5,0,29,10
2405,4055,13,2014/2015,2014-11-29 00:00:00,Swansea City,Crystal Palace,1,1,1.8,3.75,5.0,5,5,12,4,6,12,0,2,0,0,30,7,4,6,64.0,36.0,2,10,16,18,2,0,37,10
2406,4057,13,2014/2015,2014-11-29 00:00:00,West Bromwich Albion,Arsenal,0,1,4.5,3.8,1.85,3,10,6,4,9,10,2,1,0,0,17,13,4,4,46.0,54.0,1,13,10,19,3,0,30,8
2407,4058,13,2014/2015,2014-11-29 00:00:00,West Ham United,Newcastle United,1,0,2.15,3.5,3.6,5,1,3,6,9,16,3,3,0,0,25,14,6,2,47.0,53.0,1,6,9,25,6,0,39,8
2408,4053,13,2014/2015,2014-11-30 00:00:00,Southampton,Manchester City,0,3,3.2,3.6,2.3,8,4,5,7,10,13,1,3,0,0,19,9,8,6,51.0,49.0,3,12,12,23,4,0,28,14
2409,4056,13,2014/2015,2014-11-30 00:00:00,Tottenham Hotspur,Everton,2,1,2.25,3.6,3.25,6,6,5,3,16,6,5,1,0,0,12,17,3,4,39.0,61.0,3,12,8,22,6,0,29,7
2410,4060,14,2014/2015,2014-12-02 00:00:00,Burnley,Newcastle United,1,1,2.8,3.3,2.75,4,5,7,5,12,12,2,2,0,0,11,15,2,5,43.0,57.0,2,9,12,24,4,0,26,7
2411,4061,14,2014/2015,2014-12-02 00:00:00,Leicester City,Liverpool,1,3,3.8,3.6,2.05,11,4,8,4,11,10,1,2,1,0,24,15,7,4,46.0,54.0,4,15,12,21,3,1,39,11
2412,4062,14,2014/2015,2014-12-02 00:00:00,Manchester United,Stoke City,2,1,1.45,4.5,8.5,1,3,6,1,8,13,2,4,0,0,24,14,2,2,64.0,36.0,3,4,7,21,6,0,38,4
2413,4063,14,2014/2015,2014-12-02 00:00:00,Swansea City,Queens Park Rangers,2,0,1.73,3.8,5.5,11,2,5,3,8,12,2,2,0,0,17,4,9,2,58.0,42.0,2,13,8,20,4,0,21,11
2414,4064,14,2014/2015,2014-12-02 00:00:00,Crystal Palace,Aston Villa,0,1,2.1,3.4,4.0,11,2,6,2,16,16,2,2,0,0,28,9,8,2,45.0,55.0,1,13,8,32,4,0,37,10
2415,4065,14,2014/2015,2014-12-02 00:00:00,West Bromwich Albion,West Ham United,1,2,2.5,3.4,3.0,12,10,10,2,11,17,2,1,0,0,23,13,6,3,57.0,43.0,3,22,12,28,3,0,36,9
2416,4059,14,2014/2015,2014-12-03 00:00:00,Arsenal,Southampton,1,0,1.8,3.75,5.0,10,3,7,3,7,14,0,2,0,0,25,17,9,4,58.0,42.0,1,13,10,21,2,0,42,13
2417,4066,14,2014/2015,2014-12-03 00:00:00,Chelsea,Tottenham Hotspur,3,0,1.4,5.0,9.0,6,4,2,7,9,9,1,1,0,0,13,20,1,6,38.0,62.0,3,10,9,18,2,0,33,7
2418,4067,14,2014/2015,2014-12-03 00:00:00,Everton,Hull City,1,1,1.53,4.33,7.0,7,3,4,5,8,13,1,1,0,0,11,22,6,4,59.0,41.0,2,10,9,21,2,0,33,10
2419,4068,14,2014/2015,2014-12-03 00:00:00,Sunderland,Manchester City,1,4,7.5,4.5,1.5,7,1,0,10,9,8,1,1,0,0,6,9,2,0,35.0,65.0,5,8,10,17,2,0,15,2
2420,4070,15,2014/2015,2014-12-06 00:00:00,Hull City,West Bromwich Albion,0,0,2.45,3.3,3.2,4,3,7,0,13,16,1,1,0,0,19,5,3,2,49.0,51.0,0,7,7,29,2,0,24,5
2421,4071,15,2014/2015,2014-12-06 00:00:00,Liverpool,Sunderland,0,0,1.5,4.5,7.5,9,2,5,5,12,15,1,3,0,0,30,15,5,7,52.0,48.0,0,11,10,27,4,0,45,12
2422,4072,15,2014/2015,2014-12-06 00:00:00,Manchester City,Everton,1,0,1.5,4.75,7.0,16,6,4,3,8,11,3,3,0,0,16,7,11,7,52.0,48.0,1,22,7,19,6,0,23,18
2423,4073,15,2014/2015,2014-12-06 00:00:00,Newcastle United,Chelsea,2,1,7.0,4.33,1.53,3,11,3,15,8,6,3,3,0,0,11,30,1,10,34.0,66.0,3,14,18,14,6,0,41,11
2424,4074,15,2014/2015,2014-12-06 00:00:00,Queens Park Rangers,Burnley,2,0,2.05,3.5,4.0,9,5,1,7,13,12,2,1,0,0,18,24,3,11,51.0,49.0,2,14,8,25,3,0,42,14
2425,4076,15,2014/2015,2014-12-06 00:00:00,Stoke City,Arsenal,3,2,4.0,3.6,2.0,3,7,7,7,17,16,3,3,0,0,15,15,3,9,43.0,57.0,5,10,14,33,6,0,30,12
2426,4077,15,2014/2015,2014-12-06 00:00:00,Tottenham Hotspur,Crystal Palace,0,0,1.6,4.2,6.0,5,8,8,6,11,10,1,0,0,0,12,15,2,12,67.0,33.0,0,13,14,21,1,0,27,14
2427,4069,15,2014/2015,2014-12-07 00:00:00,Aston Villa,Leicester City,2,1,2.4,3.4,3.2,8,4,4,5,9,14,4,4,0,1,14,16,5,5,66.0,34.0,3,12,9,23,8,1,30,10
2428,4078,15,2014/2015,2014-12-07 00:00:00,West Ham United,Swansea City,3,1,2.35,3.4,3.25,9,5,2,5,11,18,0,1,0,1,32,8,7,4,56.0,44.0,4,14,7,29,1,1,40,11
2429,4075,15,2014/2015,2014-12-08 00:00:00,Southampton,Manchester United,1,2,2.8,3.4,2.7,5,0,8,1,13,9,2,1,0,0,13,9,5,1,51.0,49.0,3,5,9,22,3,0,22,6
2430,4079,16,2014/2015,2014-12-13 00:00:00,Arsenal,Newcastle United,4,1,1.44,4.75,8.0,3,8,9,1,14,15,2,2,0,0,13,22,9,6,52.0,48.0,5,11,10,29,4,0,35,15
2431,4080,16,2014/2015,2014-12-13 00:00:00,Burnley,Southampton,1,0,5.5,3.75,1.73,4,4,2,8,15,11,1,3,0,0,12,20,2,4,40.0,60.0,1,8,10,26,4,0,32,6
2432,4081,16,2014/2015,2014-12-13 00:00:00,Chelsea,Hull City,2,0,1.18,8.0,18.0,6,1,4,6,13,13,3,4,0,1,20,14,5,4,61.0,39.0,2,7,10,26,7,1,34,9
2433,4082,16,2014/2015,2014-12-13 00:00:00,Crystal Palace,Stoke City,1,1,2.6,3.25,3.0,5,4,3,2,12,11,2,0,0,0,16,16,9,8,43.0,57.0,2,9,5,23,2,0,32,17
2434,4084,16,2014/2015,2014-12-13 00:00:00,Leicester City,Manchester City,0,1,7.0,4.75,1.5,1,5,6,3,15,11,0,2,0,0,19,7,8,2,42.0,58.0,1,6,9,26,2,0,26,10
2435,4086,16,2014/2015,2014-12-13 00:00:00,Sunderland,West Ham United,1,1,2.95,3.4,2.55,8,12,8,6,11,19,2,2,0,0,23,24,6,8,57.0,43.0,2,20,14,30,4,0,47,14
2436,4088,16,2014/2015,2014-12-13 00:00:00,West Bromwich Albion,Aston Villa,1,0,2.15,3.4,3.8,5,3,5,4,17,12,4,2,0,1,22,14,4,2,49.0,51.0,1,8,9,29,6,1,36,6
2437,4085,16,2014/2015,2014-12-14 00:00:00,Manchester United,Liverpool,3,0,1.8,3.8,4.75,5,11,2,4,13,15,4,3,0,0,13,9,2,7,54.0,46.0,3,16,6,28,7,0,22,9
2438,4087,16,2014/2015,2014-12-14 00:00:00,Swansea City,Tottenham Hotspur,1,2,2.5,3.4,3.0,7,3,6,5,7,17,3,4,0,0,30,14,7,9,53.0,47.0,3,10,11,24,7,0,44,16
2439,4083,16,2014/2015,2014-12-15 00:00:00,Everton,Queens Park Rangers,3,1,1.45,4.5,8.5,7,6,4,9,11,12,1,1,0,0,5,17,1,8,53.0,47.0,4,13,13,23,2,0,22,9
2440,4089,17,2014/2015,2014-12-20 00:00:00,Aston Villa,Manchester United,1,1,6.25,4.0,1.62,6,11,3,5,10,10,1,1,1,0,7,26,3,9,35.0,65.0,2,17,8,20,2,1,33,12
2441,4090,17,2014/2015,2014-12-20 00:00:00,Hull City,Swansea City,0,1,3.1,3.3,2.5,6,4,6,9,13,16,2,2,0,0,14,8,4,5,56.0,44.0,1,10,15,29,4,0,22,9
2442,4092,17,2014/2015,2014-12-20 00:00:00,Manchester City,Crystal Palace,3,0,1.29,6.0,12.0,3,1,9,5,17,6,2,1,0,0,16,16,8,6,74.0,26.0,3,4,14,23,3,0,32,14
2443,4094,17,2014/2015,2014-12-20 00:00:00,Queens Park Rangers,West Bromwich Albion,3,2,2.45,3.3,3.2,8,6,4,6,14,8,1,0,0,0,14,12,5,11,42.0,58.0,5,14,10,22,1,0,26,16
2444,4095,17,2014/2015,2014-12-20 00:00:00,Southampton,Everton,3,0,2.45,3.5,3.0,3,7,6,6,11,10,1,1,0,0,12,13,4,6,45.0,55.0,3,10,12,21,2,0,25,10
2445,4097,17,2014/2015,2014-12-20 00:00:00,Tottenham Hotspur,Burnley,2,1,1.5,4.5,7.5,10,5,12,6,9,8,1,0,0,0,13,10,9,6,66.0,34.0,3,15,18,17,1,0,23,15
2446,4098,17,2014/2015,2014-12-20 00:00:00,West Ham United,Leicester City,2,0,1.75,3.9,5.0,4,8,3,2,8,17,0,3,0,0,16,20,9,4,49.0,51.0,2,12,5,25,3,0,36,13
2447,4091,17,2014/2015,2014-12-21 00:00:00,Liverpool,Arsenal,2,2,2.8,3.5,2.6,12,4,13,2,6,14,1,3,0,0,10,7,10,6,63.0,37.0,4,16,15,20,4,0,17,16
2448,4093,17,2014/2015,2014-12-21 00:00:00,Newcastle United,Sunderland,0,1,2.05,3.5,4.0,9,4,9,10,15,15,4,4,0,0,19,15,7,1,51.0,49.0,1,13,19,30,8,0,34,8
2449,4096,17,2014/2015,2014-12-22 00:00:00,Stoke City,Chelsea,0,2,6.25,4.0,1.62,6,9,6,6,11,4,3,0,0,0,24,8,6,5,49.0,51.0,2,15,12,15,3,0,32,11
2450,4099,18,2014/2015,2014-12-26 00:00:00,Arsenal,Queens Park Rangers,2,1,1.29,6.0,13.0,5,6,7,8,6,16,1,4,1,0,8,19,6,2,58.0,42.0,3,11,15,22,5,1,27,8
2451,4100,18,2014/2015,2014-12-26 00:00:00,Burnley,Liverpool,0,1,4.75,3.8,1.8,4,6,14,3,7,5,0,1,0,0,22,5,8,2,47.0,53.0,1,10,17,12,1,0,27,10
2452,4101,18,2014/2015,2014-12-26 00:00:00,Chelsea,West Ham United,2,0,1.33,5.75,10.0,11,0,14,5,8,14,0,3,0,0,11,14,8,6,66.0,34.0,2,11,19,22,3,0,25,14
2453,4102,18,2014/2015,2014-12-26 00:00:00,Crystal Palace,Southampton,1,3,3.75,3.4,2.15,7,4,3,6,15,10,1,0,0,0,30,10,8,4,42.0,58.0,4,11,9,25,1,0,40,12
2454,4103,18,2014/2015,2014-12-26 00:00:00,Everton,Stoke City,0,1,1.83,3.6,5.0,9,4,4,5,9,15,2,3,0,0,16,13,9,3,62.0,38.0,1,13,9,24,5,0,29,12
2455,4104,18,2014/2015,2014-12-26 00:00:00,Leicester City,Tottenham Hotspur,1,2,3.8,3.6,2.05,11,4,9,2,10,14,1,2,0,0,5,4,11,1,44.0,56.0,3,15,11,24,3,0,9,12
2456,4105,18,2014/2015,2014-12-26 00:00:00,Manchester United,Newcastle United,3,1,1.4,5.0,9.0,2,4,5,2,17,10,1,2,0,0,12,15,4,5,62.0,38.0,4,6,7,27,3,0,27,9
2457,4106,18,2014/2015,2014-12-26 00:00:00,Sunderland,Hull City,1,3,2.05,3.4,4.2,5,5,5,6,12,6,4,2,0,0,4,8,10,4,47.0,53.0,4,10,11,18,6,0,12,14
2458,4107,18,2014/2015,2014-12-26 00:00:00,Swansea City,Aston Villa,1,0,1.75,3.75,5.25,2,5,3,9,18,13,1,4,0,0,13,17,4,0,43.0,57.0,1,7,12,31,5,0,30,4
2459,4108,18,2014/2015,2014-12-26 00:00:00,West Bromwich Albion,Manchester City,1,3,6.5,4.5,1.53,9,2,6,5,5,9,0,1,0,0,13,7,10,6,47.0,53.0,4,11,11,14,1,0,20,16
2460,4109,19,2014/2015,2014-12-28 00:00:00,Aston Villa,Sunderland,0,0,2.35,3.3,3.4,6,7,7,7,5,11,1,3,1,0,20,16,4,4,48.0,52.0,0,13,14,16,4,1,36,8
2461,4110,19,2014/2015,2014-12-28 00:00:00,Hull City,Leicester City,0,1,2.25,3.4,3.5,11,1,6,2,12,14,0,2,1,0,26,10,7,1,63.0,37.0,1,12,8,26,2,1,36,8
2462,4112,19,2014/2015,2014-12-28 00:00:00,Manchester City,Burnley,2,2,1.18,8.0,19.0,7,3,7,6,18,9,4,1,0,0,17,14,10,3,64.0,36.0,4,10,13,27,5,0,31,13
2463,4113,19,2014/2015,2014-12-28 00:00:00,Newcastle United,Everton,3,2,2.9,3.4,2.6,9,1,4,7,13,8,2,2,0,0,22,12,8,3,53.0,47.0,5,10,11,21,4,0,34,11
2464,4114,19,2014/2015,2014-12-28 00:00:00,Queens Park Rangers,Crystal Palace,0,0,2.38,3.4,3.25,8,4,2,6,11,17,2,1,0,0,28,19,9,4,54.0,46.0,0,12,8,28,3,0,47,13
2465,4115,19,2014/2015,2014-12-28 00:00:00,Southampton,Chelsea,1,1,4.75,3.75,1.83,1,5,5,2,23,14,3,2,0,0,10,28,4,6,40.0,60.0,2,6,7,37,5,0,38,10
2466,4116,19,2014/2015,2014-12-28 00:00:00,Stoke City,West Bromwich Albion,2,0,1.91,3.6,4.5,7,6,4,7,10,13,0,2,0,0,17,16,5,3,50.0,50.0,2,13,11,23,2,0,33,8
2467,4117,19,2014/2015,2014-12-28 00:00:00,Tottenham Hotspur,Manchester United,0,0,3.25,3.6,2.3,7,7,4,3,11,19,2,4,0,0,20,15,3,6,47.0,53.0,0,14,7,30,6,0,35,9
2468,4118,19,2014/2015,2014-12-28 00:00:00,West Ham United,Arsenal,1,2,3.5,3.5,2.2,7,14,6,6,13,13,3,3,0,0,37,10,7,8,56.0,44.0,3,21,12,26,6,0,47,15
2469,4111,19,2014/2015,2014-12-29 00:00:00,Liverpool,Swansea City,4,1,1.7,4.0,5.5,10,4,8,5,8,5,1,0,0,0,10,20,6,3,48.0,52.0,5,14,13,13,1,0,30,9
2470,4129,20,2014/2015,2015-01-01 00:00:00,Aston Villa,Crystal Palace,0,0,2.4,3.3,3.3,7,2,10,4,11,12,1,1,0,0,21,13,5,2,70.0,30.0,0,9,14,23,2,0,34,7
2471,4130,20,2014/2015,2015-01-01 00:00:00,Hull City,Everton,2,0,3.4,3.4,2.3,9,5,5,5,15,15,3,4,0,0,15,14,4,8,44.0,56.0,2,14,10,30,7,0,29,12
2472,4131,20,2014/2015,2015-01-01 00:00:00,Liverpool,Leicester City,2,2,1.4,5.0,9.0,7,5,9,9,13,11,2,2,0,0,8,15,4,5,59.0,41.0,4,12,18,24,4,0,23,9
2473,4132,20,2014/2015,2015-01-01 00:00:00,Manchester City,Sunderland,3,2,1.22,7.0,15.0,18,2,12,0,14,7,2,3,0,0,22,7,10,4,64.0,36.0,5,20,12,21,5,0,29,14
2474,4133,20,2014/2015,2015-01-01 00:00:00,Newcastle United,Burnley,3,3,1.83,3.75,4.75,2,5,4,9,12,13,2,4,0,0,9,10,5,5,52.0,48.0,6,7,13,25,6,0,19,10
2475,4134,20,2014/2015,2015-01-01 00:00:00,Queens Park Rangers,Swansea City,1,1,3.0,3.4,2.5,12,11,8,11,20,6,4,0,0,1,20,15,4,9,42.0,58.0,2,23,19,26,4,1,35,13
2476,4135,20,2014/2015,2015-01-01 00:00:00,Southampton,Arsenal,2,0,2.9,3.4,2.6,5,7,6,3,14,7,2,1,0,0,17,26,2,7,41.0,59.0,2,12,9,21,3,0,43,9
2477,4136,20,2014/2015,2015-01-01 00:00:00,Stoke City,Manchester United,1,1,4.2,3.5,2.0,4,2,6,4,8,12,0,0,0,0,14,16,11,7,35.0,65.0,2,6,10,20,0,0,30,18
2478,4137,20,2014/2015,2015-01-01 00:00:00,Tottenham Hotspur,Chelsea,5,3,5.0,3.75,1.8,4,7,1,7,14,10,3,1,0,0,9,14,5,3,46.0,54.0,8,11,8,24,4,0,23,8
2479,4138,20,2014/2015,2015-01-01 00:00:00,West Ham United,West Bromwich Albion,1,1,1.85,3.75,4.5,3,4,4,8,6,13,1,0,0,0,23,8,0,1,46.0,54.0,2,7,12,19,1,0,31,1
2480,4140,21,2014/2015,2015-01-10 00:00:00,Burnley,Queens Park Rangers,2,1,2.2,3.4,3.6,5,8,7,7,14,9,2,2,0,0,16,12,10,6,46.0,54.0,3,13,14,23,4,0,28,16
2481,4141,21,2014/2015,2015-01-10 00:00:00,Chelsea,Newcastle United,2,0,1.2,7.5,17.0,4,6,5,3,13,13,2,3,0,0,15,16,7,4,63.0,37.0,2,10,8,26,5,0,31,11
2482,4142,21,2014/2015,2015-01-10 00:00:00,Crystal Palace,Tottenham Hotspur,2,1,3.5,3.5,2.2,12,4,6,3,9,14,5,3,0,0,26,18,4,6,42.0,58.0,3,16,9,23,8,0,44,10
2483,4143,21,2014/2015,2015-01-10 00:00:00,Everton,Manchester City,1,1,4.5,3.75,1.85,7,7,2,9,9,10,1,2,0,0,12,12,4,9,38.0,62.0,2,14,11,19,3,0,24,13
2484,4144,21,2014/2015,2015-01-10 00:00:00,Leicester City,Aston Villa,1,0,2.2,3.4,3.6,5,5,7,8,17,6,1,2,1,0,18,13,6,6,38.0,62.0,1,10,15,23,3,1,31,12
2485,4146,21,2014/2015,2015-01-10 00:00:00,Sunderland,Liverpool,0,1,4.5,3.6,1.91,2,7,2,11,13,11,2,4,0,0,14,7,6,6,47.0,53.0,1,9,13,24,6,0,21,12
2486,4147,21,2014/2015,2015-01-10 00:00:00,Swansea City,West Ham United,1,1,2.25,3.5,3.4,11,7,5,4,9,8,0,1,0,0,14,17,4,5,60.0,40.0,2,18,9,17,1,0,31,9
2487,4148,21,2014/2015,2015-01-10 00:00:00,West Bromwich Albion,Hull City,1,0,2.05,3.4,4.2,3,5,4,7,6,13,1,0,0,0,9,19,5,2,53.0,47.0,1,8,11,19,1,0,28,7
2488,4139,21,2014/2015,2015-01-11 00:00:00,Arsenal,Stoke City,3,0,1.44,4.75,8.0,4,2,7,4,11,12,0,3,0,0,11,24,9,1,53.0,47.0,3,6,11,23,3,0,35,10
2489,4145,21,2014/2015,2015-01-11 00:00:00,Manchester United,Southampton,0,1,1.83,3.75,4.75,1,1,7,6,9,10,2,3,0,0,33,15,3,5,61.0,39.0,1,2,13,19,5,0,48,8
2490,4149,22,2014/2015,2015-01-17 00:00:00,Aston Villa,Liverpool,0,2,4.5,3.6,1.91,5,7,10,6,13,11,1,1,0,0,21,13,9,5,49.0,51.0,2,12,16,24,2,0,34,14
2491,4150,22,2014/2015,2015-01-17 00:00:00,Burnley,Crystal Palace,2,3,2.55,3.25,3.1,2,3,0,6,6,18,1,3,0,0,10,12,5,7,50.0,50.0,5,5,6,24,4,0,22,12
2492,4152,22,2014/2015,2015-01-17 00:00:00,Leicester City,Stoke City,0,1,2.63,3.3,2.9,6,6,2,4,9,6,1,0,0,0,15,2,6,5,42.0,58.0,1,12,6,15,1,0,17,11
2493,4154,22,2014/2015,2015-01-17 00:00:00,Newcastle United,Southampton,1,2,3.3,3.3,2.38,4,1,10,2,11,8,0,2,0,0,27,11,9,0,52.0,48.0,3,5,12,19,2,0,38,9
2494,4155,22,2014/2015,2015-01-17 00:00:00,Queens Park Rangers,Manchester United,0,2,6.0,4.2,1.62,7,9,7,1,12,10,3,2,0,0,24,11,3,3,36.0,64.0,2,16,8,22,5,0,35,6
2495,4156,22,2014/2015,2015-01-17 00:00:00,Swansea City,Chelsea,0,5,7.0,4.2,1.55,3,7,6,8,9,13,0,0,0,0,7,8,1,2,46.0,54.0,5,10,14,22,0,0,15,3
2496,4157,22,2014/2015,2015-01-17 00:00:00,Tottenham Hotspur,Sunderland,2,1,1.62,4.2,6.0,14,4,8,1,13,8,1,2,0,0,11,7,6,6,66.0,34.0,3,18,9,21,3,0,18,12
2497,4153,22,2014/2015,2015-01-18 00:00:00,Manchester City,Arsenal,0,2,1.8,4.0,4.5,6,2,4,4,12,6,3,3,0,0,20,7,16,3,66.0,34.0,2,8,8,18,6,0,27,19
2498,4158,22,2014/2015,2015-01-18 00:00:00,West Ham United,Hull City,3,0,1.75,3.75,5.25,6,5,8,3,5,14,1,3,0,0,21,13,4,7,54.0,46.0,3,11,11,19,4,0,34,11
2499,4151,22,2014/2015,2015-01-19 00:00:00,Everton,West Bromwich Albion,0,0,1.85,3.6,4.75,9,2,5,2,12,14,3,2,0,0,30,6,8,1,68.0,32.0,0,11,7,26,5,0,36,9
2500,4160,23,2014/2015,2015-01-31 00:00:00,Chelsea,Manchester City,1,1,2.15,3.5,3.6,1,4,1,5,12,14,0,2,0,0,9,17,1,8,43.0,57.0,2,5,6,26,2,0,26,9
2501,4161,23,2014/2015,2015-01-31 00:00:00,Crystal Palace,Everton,0,1,2.8,3.3,2.75,7,5,8,5,12,14,0,3,0,0,50,9,6,1,54.0,46.0,1,12,13,26,3,0,59,7
2502,4162,23,2014/2015,2015-01-31 00:00:00,Hull City,Newcastle United,0,3,2.7,3.25,2.88,9,3,4,4,15,13,4,1,0,0,17,7,3,3,53.0,47.0,3,12,8,28,5,0,24,6
2503,4163,23,2014/2015,2015-01-31 00:00:00,Liverpool,West Ham United,2,0,1.67,4.0,5.75,10,4,9,2,12,15,1,1,0,0,12,12,5,7,66.0,34.0,2,14,11,27,2,0,24,12
2504,4164,23,2014/2015,2015-01-31 00:00:00,Manchester United,Leicester City,3,1,1.36,5.5,9.5,7,0,4,3,8,12,0,1,0,0,21,14,4,3,72.0,28.0,4,7,7,20,1,0,35,7
2505,4166,23,2014/2015,2015-01-31 00:00:00,Stoke City,Queens Park Rangers,3,1,1.65,4.0,6.0,2,5,8,8,11,12,2,2,0,0,13,6,3,5,52.0,48.0,4,7,16,23,4,0,19,8
2506,4167,23,2014/2015,2015-01-31 00:00:00,Sunderland,Burnley,2,0,2.25,3.3,3.6,4,4,3,10,12,12,3,1,0,0,12,20,6,3,50.0,50.0,2,8,13,24,4,0,32,9
2507,4168,23,2014/2015,2015-01-31 00:00:00,West Bromwich Albion,Tottenham Hotspur,0,3,2.9,3.3,2.63,7,6,6,6,8,13,2,1,0,0,13,6,6,3,38.0,62.0,3,13,12,21,3,0,19,9
2508,4159,23,2014/2015,2015-02-01 00:00:00,Arsenal,Aston Villa,5,0,1.25,6.5,15.0,3,4,5,5,6,10,0,2,0,0,14,23,7,7,48.0,52.0,5,7,10,16,2,0,37,14
2509,4165,23,2014/2015,2015-02-01 00:00:00,Southampton,Swansea City,0,1,1.6,4.0,6.5,10,2,6,3,11,9,1,1,1,0,30,3,9,0,63.0,37.0,1,12,9,20,2,1,33,9
2510,4169,24,2014/2015,2015-02-07 00:00:00,Aston Villa,Chelsea,1,2,10.0,5.25,1.36,1,5,7,4,9,7,3,2,0,0,27,4,7,7,50.0,50.0,3,6,11,16,5,0,31,14
2511,4171,24,2014/2015,2015-02-07 00:00:00,Everton,Liverpool,0,0,3.4,3.4,2.3,2,12,2,4,11,8,4,1,0,0,9,9,3,6,44.0,56.0,0,14,6,19,5,0,18,9
2512,4172,24,2014/2015,2015-02-07 00:00:00,Leicester City,Crystal Palace,0,1,2.4,3.3,3.25,12,6,8,9,17,7,4,1,0,0,17,19,8,6,63.0,37.0,1,18,17,24,5,0,36,14
2513,4173,24,2014/2015,2015-02-07 00:00:00,Manchester City,Hull City,1,1,1.18,8.0,19.0,10,3,3,3,9,8,2,4,0,0,14,6,13,1,74.0,26.0,2,13,6,17,6,0,20,14
2514,4175,24,2014/2015,2015-02-07 00:00:00,Queens Park Rangers,Southampton,0,1,4.75,3.6,1.85,6,5,5,7,13,16,2,2,0,0,13,13,3,4,45.0,55.0,1,11,12,29,4,0,26,7
2515,4176,24,2014/2015,2015-02-07 00:00:00,Swansea City,Sunderland,1,1,1.91,3.5,4.6,10,2,8,2,11,13,3,4,0,0,19,6,7,1,61.0,39.0,2,12,10,24,7,0,25,8
2516,4177,24,2014/2015,2015-02-07 00:00:00,Tottenham Hotspur,Arsenal,2,1,3.25,3.5,2.3,10,4,11,1,8,12,3,5,0,0,18,14,10,3,56.0,44.0,3,14,12,20,8,0,32,13
2517,4170,24,2014/2015,2015-02-08 00:00:00,Burnley,West Bromwich Albion,2,2,2.6,3.25,3.0,7,4,3,2,10,16,0,4,0,0,20,15,5,6,55.0,45.0,4,11,5,26,4,0,35,11
2518,4174,24,2014/2015,2015-02-08 00:00:00,Newcastle United,Stoke City,1,1,2.3,3.4,3.4,3,4,4,2,14,17,2,4,0,0,13,14,5,8,42.0,58.0,2,7,6,31,6,0,27,13
2519,4178,24,2014/2015,2015-02-08 00:00:00,West Ham United,Manchester United,1,1,4.2,3.6,1.95,8,10,5,7,7,14,2,3,0,0,23,23,9,9,41.0,59.0,2,18,12,21,5,0,46,18
2520,4179,25,2014/2015,2015-02-10 00:00:00,Arsenal,Leicester City,2,1,1.29,6.0,12.0,10,5,4,5,13,15,2,2,0,0,5,19,6,6,58.0,42.0,3,15,9,28,4,0,24,12
2521,4180,25,2014/2015,2015-02-10 00:00:00,Hull City,Aston Villa,2,0,2.38,3.1,3.5,4,4,4,6,16,11,1,2,0,0,8,13,3,7,37.0,63.0,2,8,10,27,3,0,21,10
2522,4184,25,2014/2015,2015-02-10 00:00:00,Liverpool,Tottenham Hotspur,3,2,1.91,3.8,4.2,8,8,5,6,14,17,3,6,0,0,8,5,5,7,50.0,50.0,5,16,11,31,9,0,13,12
2523,4188,25,2014/2015,2015-02-10 00:00:00,Sunderland,Queens Park Rangers,0,2,1.91,3.6,4.5,8,7,3,8,8,12,2,3,0,0,21,15,8,4,53.0,47.0,2,15,11,20,5,0,36,12
2524,4181,25,2014/2015,2015-02-11 00:00:00,Manchester United,Burnley,3,1,1.29,6.0,12.0,4,3,3,9,15,9,4,3,0,0,17,21,5,8,57.0,43.0,4,7,12,24,7,0,38,13
2525,4182,25,2014/2015,2015-02-11 00:00:00,Southampton,West Ham United,0,0,1.73,3.9,5.25,11,4,7,0,12,11,2,1,0,1,25,7,8,2,67.0,33.0,0,15,7,23,3,1,32,10
2526,4183,25,2014/2015,2015-02-11 00:00:00,Crystal Palace,Newcastle United,1,1,2.38,3.3,3.3,3,0,4,2,10,11,1,2,0,0,28,12,5,2,54.0,46.0,2,3,6,21,3,0,40,7
2527,4185,25,2014/2015,2015-02-11 00:00:00,West Bromwich Albion,Swansea City,2,0,2.55,3.25,3.1,6,4,5,5,11,12,2,1,0,0,13,17,5,4,37.0,63.0,2,10,10,23,3,0,30,9
2528,4186,25,2014/2015,2015-02-11 00:00:00,Chelsea,Everton,1,0,1.33,5.5,11.0,12,5,9,2,8,14,3,4,0,0,31,7,10,2,54.0,46.0,1,17,11,22,7,0,38,12
2529,4187,25,2014/2015,2015-02-11 00:00:00,Stoke City,Manchester City,1,4,5.75,3.8,1.7,3,4,8,4,6,11,1,2,0,0,30,12,3,2,50.0,50.0,5,7,12,17,3,0,42,5
2530,4189,26,2014/2015,2015-02-21 00:00:00,Aston Villa,Stoke City,1,2,2.7,3.2,2.9,2,6,0,2,11,14,2,3,0,0,18,17,11,3,52.0,48.0,3,8,2,25,5,0,35,14
2531,4190,26,2014/2015,2015-02-21 00:00:00,Chelsea,Burnley,1,1,1.2,7.5,17.0,4,5,9,4,9,9,1,2,1,0,9,11,7,7,61.0,39.0,2,9,13,18,3,1,20,14
2532,4191,26,2014/2015,2015-02-21 00:00:00,Crystal Palace,Arsenal,1,2,4.75,3.75,1.83,9,7,7,3,14,14,1,3,0,0,33,6,10,1,53.0,47.0,3,16,10,28,4,0,39,11
2533,4193,26,2014/2015,2015-02-21 00:00:00,Hull City,Queens Park Rangers,2,1,2.05,3.3,4.2,4,3,8,3,18,16,0,4,0,1,20,14,5,7,55.0,45.0,3,7,11,34,4,1,34,12
2534,4194,26,2014/2015,2015-02-21 00:00:00,Manchester City,Newcastle United,5,0,1.3,6.0,11.0,4,2,6,4,9,8,3,2,0,0,7,16,7,3,57.0,43.0,5,6,10,17,5,0,23,10
2535,4196,26,2014/2015,2015-02-21 00:00:00,Sunderland,West Bromwich Albion,0,0,2.7,3.2,2.9,6,2,7,1,11,12,1,2,0,0,28,23,11,2,61.0,39.0,0,8,8,23,3,0,51,13
2536,4197,26,2014/2015,2015-02-21 00:00:00,Swansea City,Manchester United,2,1,4.2,3.5,2.0,5,7,3,9,6,15,2,4,0,0,10,31,4,10,36.0,64.0,3,12,12,21,6,0,41,14
2537,4192,26,2014/2015,2015-02-22 00:00:00,Everton,Leicester City,2,2,1.83,3.6,5.0,5,7,9,6,7,6,0,1,0,0,11,17,4,7,59.0,41.0,4,12,15,13,1,0,28,11
2538,4195,26,2014/2015,2015-02-22 00:00:00,Southampton,Liverpool,0,2,2.63,3.3,2.9,13,2,2,2,11,14,2,3,0,0,18,3,6,1,60.0,40.0,2,15,4,25,5,0,21,7
2539,4198,26,2014/2015,2015-02-22 00:00:00,Tottenham Hotspur,West Ham United,2,2,1.8,3.8,4.75,11,6,11,2,6,12,0,2,0,0,14,13,7,9,64.0,36.0,4,17,13,18,2,0,27,16
2540,4200,27,2014/2015,2015-02-28 00:00:00,Burnley,Swansea City,0,1,2.63,3.3,2.9,7,3,3,5,14,8,0,0,0,0,21,8,6,4,46.0,54.0,1,10,8,22,0,0,29,10
2541,4203,27,2014/2015,2015-02-28 00:00:00,Manchester United,Sunderland,2,0,1.36,5.25,10.0,11,2,11,2,6,12,1,1,0,1,23,5,12,1,73.0,27.0,2,13,13,18,2,1,28,13
2542,4204,27,2014/2015,2015-02-28 00:00:00,Newcastle United,Aston Villa,1,0,1.95,3.5,4.5,5,6,5,6,6,16,1,5,0,0,10,14,9,5,50.0,50.0,1,11,11,22,6,0,24,14
2543,4206,27,2014/2015,2015-02-28 00:00:00,Stoke City,Hull City,1,0,1.91,3.5,4.75,10,2,6,1,8,10,2,2,0,0,16,5,5,2,62.0,38.0,1,12,7,18,4,0,21,7
2544,4207,27,2014/2015,2015-02-28 00:00:00,West Bromwich Albion,Southampton,1,0,3.4,3.2,2.38,3,3,2,10,10,17,2,1,0,0,16,22,2,3,36.0,64.0,1,6,12,27,3,0,38,5
2545,4208,27,2014/2015,2015-02-28 00:00:00,West Ham United,Crystal Palace,1,3,2.15,3.4,3.75,5,4,10,4,13,20,2,3,0,0,21,13,11,7,65.0,35.0,4,9,14,33,5,0,34,18
2546,4199,27,2014/2015,2015-03-01 00:00:00,Arsenal,Everton,2,0,1.57,4.5,6.0,7,5,10,4,12,5,2,0,0,0,22,32,8,9,48.0,52.0,2,12,14,17,2,0,54,17
2547,4202,27,2014/2015,2015-03-01 00:00:00,Liverpool,Manchester City,2,1,3.1,3.6,2.38,3,0,5,6,8,16,1,3,0,0,11,20,3,0,48.0,52.0,3,3,11,24,4,0,31,3
2548,4209,28,2014/2015,2015-03-03 00:00:00,Aston Villa,West Bromwich Albion,2,1,2.88,3.1,2.88,7,1,7,1,15,13,2,4,0,0,17,14,0,3,58.0,42.0,3,8,8,28,6,0,31,3
2549,4210,28,2014/2015,2015-03-03 00:00:00,Hull City,Sunderland,1,1,2.15,3.3,3.9,7,3,6,4,9,14,2,6,0,0,26,16,6,4,41.0,59.0,2,10,10,23,8,0,42,10
2550,4212,28,2014/2015,2015-03-03 00:00:00,Southampton,Crystal Palace,1,0,1.7,3.8,5.75,7,7,11,2,11,10,0,2,0,0,17,17,10,2,63.0,37.0,1,14,13,21,2,0,34,12
2551,4211,28,2014/2015,2015-03-04 00:00:00,Queens Park Rangers,Arsenal,1,2,7.0,4.33,1.53,8,11,3,6,10,9,2,1,0,0,25,20,1,6,42.0,58.0,3,19,9,19,3,0,45,7
2552,4213,28,2014/2015,2015-03-04 00:00:00,West Ham United,Chelsea,0,1,6.25,4.0,1.62,12,7,6,3,10,10,3,4,0,0,32,20,5,4,45.0,55.0,1,19,9,20,7,0,52,9
2553,4214,28,2014/2015,2015-03-04 00:00:00,Liverpool,Burnley,2,0,1.36,5.25,10.0,11,4,6,4,8,14,0,1,0,0,5,7,6,5,65.0,35.0,2,15,10,22,1,0,12,11
2554,4215,28,2014/2015,2015-03-04 00:00:00,Manchester City,Leicester City,2,0,1.25,7.0,13.0,13,4,7,3,11,3,0,1,0,0,16,6,10,3,70.0,30.0,2,17,10,14,1,0,22,13
2555,4216,28,2014/2015,2015-03-04 00:00:00,Newcastle United,Manchester United,0,1,4.2,3.5,2.0,2,5,3,5,6,14,1,2,0,0,13,19,4,1,31.0,69.0,1,7,8,20,3,0,32,5
2556,4217,28,2014/2015,2015-03-04 00:00:00,Stoke City,Everton,2,0,2.5,3.3,3.1,4,7,3,1,11,14,2,2,0,0,24,16,5,6,44.0,56.0,2,11,4,25,4,0,40,11
2557,4218,28,2014/2015,2015-03-04 00:00:00,Tottenham Hotspur,Swansea City,3,2,1.75,3.8,5.25,10,4,4,2,14,7,1,0,0,0,18,9,6,4,61.0,39.0,5,14,6,21,1,0,27,10
2558,4205,27,2014/2015,2015-03-07 00:00:00,Queens Park Rangers,Tottenham Hotspur,1,2,4.75,3.9,1.8,11,6,6,5,15,12,1,2,0,0,11,7,3,5,37.0,63.0,3,17,11,27,3,0,18,8
2559,4219,29,2014/2015,2015-03-14 00:00:00,Arsenal,West Ham United,3,0,1.4,5.0,9.0,8,2,5,4,10,10,1,1,0,0,29,18,7,5,68.0,32.0,3,10,9,20,2,0,47,12
2560,4220,29,2014/2015,2015-03-14 00:00:00,Burnley,Manchester City,1,0,7.5,5.0,1.44,2,12,6,9,6,9,2,1,0,0,13,28,2,6,30.0,70.0,1,14,15,15,3,0,41,8
2561,4222,29,2014/2015,2015-03-14 00:00:00,Crystal Palace,Queens Park Rangers,3,1,1.83,3.75,4.75,2,4,6,4,17,16,1,3,0,0,19,16,6,3,43.0,57.0,4,6,10,33,4,0,35,9
2562,4224,29,2014/2015,2015-03-14 00:00:00,Leicester City,Hull City,0,0,2.2,3.3,3.75,8,6,9,4,10,15,0,5,0,0,21,21,7,5,49.0,51.0,0,14,13,25,5,0,42,12
2563,4226,29,2014/2015,2015-03-14 00:00:00,Sunderland,Aston Villa,0,4,2.38,3.25,3.4,4,5,6,4,10,9,1,1,0,0,15,5,2,5,40.0,60.0,4,9,10,19,2,0,20,7
2564,4228,29,2014/2015,2015-03-14 00:00:00,West Bromwich Albion,Stoke City,1,0,2.38,3.25,3.4,9,4,4,3,7,16,1,2,0,0,16,17,7,5,43.0,57.0,1,13,7,23,3,0,33,12
2565,4221,29,2014/2015,2015-03-15 00:00:00,Chelsea,Southampton,1,1,1.62,4.0,6.5,9,6,10,4,10,11,3,3,0,0,12,12,9,2,60.0,40.0,2,15,14,21,6,0,24,11
2566,4223,29,2014/2015,2015-03-15 00:00:00,Everton,Newcastle United,3,0,1.83,3.75,4.75,9,8,3,5,11,9,1,2,0,1,8,15,3,4,53.0,47.0,3,17,8,20,3,1,23,7
2567,4225,29,2014/2015,2015-03-15 00:00:00,Manchester United,Tottenham Hotspur,3,0,1.91,3.75,4.33,2,2,5,2,12,10,1,1,0,0,12,9,4,2,52.0,48.0,3,4,7,22,2,0,21,6
2568,4227,29,2014/2015,2015-03-16 00:00:00,Swansea City,Liverpool,0,1,4.0,3.6,2.0,8,6,2,7,13,15,0,3,0,0,14,7,4,5,46.0,54.0,1,14,9,28,3,0,21,9
2569,4239,30,2014/2015,2015-03-21 00:00:00,Aston Villa,Swansea City,0,1,2.5,3.25,2.8,7,8,6,2,13,11,0,0,0,0,9,7,4,9,41.0,59.0,1,15,8,24,0,0,16,13
2570,4242,30,2014/2015,2015-03-21 00:00:00,Manchester City,West Bromwich Albion,3,0,1.3,5.5,8.5,20,0,17,2,6,5,0,0,0,1,10,5,9,2,79.0,21.0,3,20,19,11,0,1,15,11
2571,4243,30,2014/2015,2015-03-21 00:00:00,Newcastle United,Arsenal,1,2,6.0,3.8,1.57,8,3,7,2,11,7,0,0,0,0,11,13,9,4,50.0,50.0,3,11,9,18,0,0,24,13
2572,4245,30,2014/2015,2015-03-21 00:00:00,Southampton,Burnley,2,0,1.4,4.5,7.5,8,4,10,7,10,7,0,0,0,0,18,15,10,5,60.0,40.0,2,12,17,17,0,0,33,15
2573,4246,30,2014/2015,2015-03-21 00:00:00,Stoke City,Crystal Palace,1,2,2.1,3.3,3.5,6,3,8,6,15,14,3,4,0,0,29,11,8,4,57.0,43.0,3,9,14,29,7,0,40,12
2574,4247,30,2014/2015,2015-03-21 00:00:00,Tottenham Hotspur,Leicester City,4,3,1.53,4.0,6.0,2,3,5,6,7,9,2,1,0,0,15,22,4,4,67.0,33.0,7,5,11,16,3,0,37,8
2575,4248,30,2014/2015,2015-03-21 00:00:00,West Ham United,Sunderland,1,0,1.8,3.5,4.5,8,4,4,3,15,11,0,1,0,0,30,8,6,4,55.0,45.0,1,12,7,26,1,0,38,10
2576,4240,30,2014/2015,2015-03-22 00:00:00,Hull City,Chelsea,2,3,7.0,4.33,1.44,9,4,8,2,14,11,0,2,0,0,16,12,6,6,41.0,59.0,5,13,10,25,2,0,28,12
2577,4241,30,2014/2015,2015-03-22 00:00:00,Liverpool,Manchester United,1,2,2.05,3.4,3.6,2,3,3,1,14,17,2,2,1,0,8,11,2,3,42.0,58.0,3,5,4,31,4,1,19,5
2578,4244,30,2014/2015,2015-03-22 00:00:00,Queens Park Rangers,Everton,1,2,3.3,3.4,2.15,4,3,10,2,11,12,2,1,0,0,32,5,1,3,53.0,47.0,3,7,12,23,3,0,37,4
2579,4249,31,2014/2015,2015-04-04 00:00:00,Arsenal,Liverpool,4,1,1.83,3.75,4.2,6,4,6,7,7,10,1,1,0,0,14,7,6,5,48.0,52.0,5,10,13,17,2,0,21,11
2580,4251,31,2014/2015,2015-04-04 00:00:00,Chelsea,Stoke City,2,1,1.29,5.5,11.0,11,2,6,3,5,22,1,6,0,0,12,6,9,0,61.0,39.0,3,13,9,27,7,0,18,9
2581,4253,31,2014/2015,2015-04-04 00:00:00,Everton,Southampton,1,0,2.63,3.2,2.8,5,5,6,6,12,17,0,1,0,0,11,14,4,10,45.0,55.0,1,10,12,29,1,0,25,14
2582,4254,31,2014/2015,2015-04-04 00:00:00,Leicester City,West Ham United,2,1,2.38,3.3,3.1,6,8,9,7,12,10,0,4,0,0,23,22,7,6,51.0,49.0,3,14,16,22,4,0,45,13
2583,4255,31,2014/2015,2015-04-04 00:00:00,Manchester United,Aston Villa,3,1,1.3,5.5,10.0,8,2,8,2,15,12,0,1,0,0,27,7,10,2,77.0,23.0,4,10,10,27,1,0,34,12
2584,4257,31,2014/2015,2015-04-04 00:00:00,Swansea City,Hull City,3,1,1.91,3.5,4.2,3,4,4,3,10,13,1,5,0,1,9,15,4,7,60.0,40.0,4,7,7,23,6,1,24,11
2585,4258,31,2014/2015,2015-04-04 00:00:00,West Bromwich Albion,Queens Park Rangers,1,4,1.8,3.5,4.5,7,5,7,2,6,15,2,3,1,0,24,6,2,4,57.0,43.0,5,12,9,21,5,1,30,6
2586,4250,31,2014/2015,2015-04-05 00:00:00,Burnley,Tottenham Hotspur,0,0,3.5,3.4,2.1,9,5,4,7,9,5,2,0,0,0,23,10,5,3,40.0,60.0,0,14,11,14,2,0,33,8
2587,4256,31,2014/2015,2015-04-05 00:00:00,Sunderland,Newcastle United,1,0,2.5,3.1,3.1,10,4,7,6,14,18,5,2,0,0,20,14,8,4,54.0,46.0,1,14,13,32,7,0,34,12
2588,4252,31,2014/2015,2015-04-06 00:00:00,Crystal Palace,Manchester City,2,1,5.0,4.0,1.67,1,10,1,13,11,11,2,1,0,0,4,14,4,13,26.0,74.0,3,11,14,22,3,0,18,17
2589,4270,33,2014/2015,2015-04-07 00:00:00,Aston Villa,Queens Park Rangers,3,3,2.15,3.4,3.8,9,4,6,1,8,12,0,4,0,0,22,15,7,3,64.0,36.0,6,13,7,20,4,0,37,10
2590,4259,32,2014/2015,2015-04-11 00:00:00,Burnley,Arsenal,0,1,6.5,4.33,1.57,6,9,2,8,15,7,2,0,0,0,16,13,1,6,31.0,69.0,1,15,10,22,2,0,29,7
2591,4263,32,2014/2015,2015-04-11 00:00:00,Southampton,Hull City,2,0,1.53,4.2,7.5,5,8,2,7,7,12,2,0,0,0,15,19,2,5,55.0,45.0,2,13,9,19,2,0,34,7
2592,4264,32,2014/2015,2015-04-11 00:00:00,Sunderland,Crystal Palace,1,4,2.9,3.2,2.7,3,8,7,0,15,17,2,2,0,0,9,11,7,4,53.0,47.0,5,11,7,32,4,0,20,11
2593,4265,32,2014/2015,2015-04-11 00:00:00,Swansea City,Everton,1,1,2.5,3.3,3.1,3,8,5,2,18,12,3,3,0,0,12,11,3,6,51.0,49.0,2,11,7,30,6,0,23,9
2594,4266,32,2014/2015,2015-04-11 00:00:00,Tottenham Hotspur,Aston Villa,0,1,1.62,4.2,6.0,5,3,11,7,11,12,3,3,0,0,19,16,9,6,58.0,42.0,1,8,18,23,6,0,35,15
2595,4267,32,2014/2015,2015-04-11 00:00:00,West Bromwich Albion,Leicester City,2,3,2.3,3.4,3.4,4,4,2,5,15,15,2,2,0,0,10,28,4,6,44.0,56.0,5,8,7,30,4,0,38,10
2596,4268,32,2014/2015,2015-04-11 00:00:00,West Ham United,Stoke City,1,1,2.3,3.4,3.4,7,10,4,9,17,13,3,1,0,0,17,26,4,10,35.0,65.0,2,17,13,30,4,0,43,14
2597,4261,32,2014/2015,2015-04-12 00:00:00,Manchester United,Manchester City,4,2,2.63,3.4,2.88,6,4,0,3,9,17,0,3,0,0,14,6,1,5,58.0,42.0,6,10,3,26,3,0,20,6
2598,4262,32,2014/2015,2015-04-12 00:00:00,Queens Park Rangers,Chelsea,0,1,9.0,5.0,1.4,10,3,4,4,12,6,2,1,0,0,15,22,5,6,38.0,62.0,1,13,8,18,3,0,37,11
2599,4260,32,2014/2015,2015-04-13 00:00:00,Liverpool,Newcastle United,2,0,1.4,5.0,9.0,9,4,5,6,9,17,2,1,0,0,15,16,6,6,61.0,39.0,2,13,11,26,3,0,31,12
2600,4271,33,2014/2015,2015-04-18 00:00:00,Chelsea,Manchester United,1,0,2.0,3.4,4.33,4,5,3,9,14,12,3,1,0,0,7,17,3,7,29.0,71.0,1,9,12,26,4,0,24,10
2601,4272,33,2014/2015,2015-04-18 00:00:00,Crystal Palace,West Bromwich Albion,0,2,1.95,3.5,4.5,6,2,12,2,17,17,3,3,0,0,35,8,7,6,68.0,32.0,2,8,14,34,6,0,43,13
2602,4273,33,2014/2015,2015-04-18 00:00:00,Everton,Burnley,1,0,1.73,3.8,5.5,10,5,6,4,12,15,1,3,0,0,18,17,5,6,68.0,32.0,1,15,10,27,4,0,35,11
2603,4275,33,2014/2015,2015-04-18 00:00:00,Leicester City,Swansea City,2,0,2.15,3.4,3.75,5,7,10,3,6,5,0,2,0,0,16,10,6,3,40.0,60.0,2,12,13,11,2,0,26,9
2604,4278,33,2014/2015,2015-04-18 00:00:00,Stoke City,Southampton,2,1,3.5,3.25,2.3,4,8,8,2,17,17,0,4,0,0,25,13,2,5,52.0,48.0,3,12,10,34,4,0,38,7
2605,4276,33,2014/2015,2015-04-19 00:00:00,Manchester City,West Ham United,2,0,1.25,6.5,11.0,11,7,6,3,10,6,2,2,0,0,22,12,6,3,66.0,34.0,2,18,9,16,4,0,34,9
2606,4277,33,2014/2015,2015-04-19 00:00:00,Newcastle United,Tottenham Hotspur,1,3,3.3,3.5,2.3,7,7,3,4,11,13,2,4,0,0,20,9,4,3,37.0,63.0,4,14,7,24,6,0,29,7
2607,4280,34,2014/2015,2015-04-25 00:00:00,Burnley,Leicester City,0,1,2.63,3.3,2.9,11,4,0,1,16,16,3,0,0,0,16,16,6,4,60.0,40.0,1,15,1,32,3,0,32,10
2608,4281,34,2014/2015,2015-04-25 00:00:00,Crystal Palace,Hull City,0,2,2.05,3.3,4.2,4,7,3,12,15,9,0,0,0,0,15,20,0,9,46.0,54.0,2,11,15,24,0,0,35,9
2609,4283,34,2014/2015,2015-04-25 00:00:00,Manchester City,Aston Villa,3,2,1.29,6.0,12.0,6,4,2,6,13,11,1,2,0,0,9,22,7,6,46.0,54.0,5,10,8,24,3,0,31,13
2610,4284,34,2014/2015,2015-04-25 00:00:00,Newcastle United,Swansea City,2,3,2.45,3.25,3.25,1,3,4,4,14,9,1,2,0,0,16,8,9,6,48.0,52.0,5,4,8,23,3,0,24,15
2611,4285,34,2014/2015,2015-04-25 00:00:00,Queens Park Rangers,West Ham United,0,0,2.38,3.4,3.25,9,3,8,5,14,12,1,0,0,0,22,13,6,6,54.0,46.0,0,12,13,26,1,0,35,12
2612,4286,34,2014/2015,2015-04-25 00:00:00,Southampton,Tottenham Hotspur,2,2,2.1,3.5,3.8,4,3,6,3,9,10,1,3,0,0,15,14,8,3,36.0,64.0,4,7,9,19,4,0,29,11
2613,4287,34,2014/2015,2015-04-25 00:00:00,Stoke City,Sunderland,1,1,1.91,3.5,4.75,14,6,8,8,14,16,2,3,0,0,35,17,9,8,61.0,39.0,2,20,16,30,5,0,52,17
2614,4288,34,2014/2015,2015-04-25 00:00:00,West Bromwich Albion,Liverpool,0,0,4.0,3.6,2.0,4,13,4,10,12,12,1,0,0,0,11,18,2,4,20.0,80.0,0,17,14,24,1,0,29,6
2615,4279,34,2014/2015,2015-04-26 00:00:00,Arsenal,Chelsea,0,0,2.4,3.3,3.3,4,4,6,3,17,12,4,3,0,0,25,4,6,2,57.0,43.0,0,8,9,29,7,0,29,8
2616,4282,34,2014/2015,2015-04-26 00:00:00,Everton,Manchester United,3,0,3.75,3.4,2.15,5,12,0,5,6,10,0,2,0,0,7,26,7,7,36.0,64.0,3,17,5,16,2,0,33,14
2617,4274,33,2014/2015,2015-04-28 00:00:00,Hull City,Liverpool,1,0,4.33,3.4,2.0,5,12,2,1,10,10,2,0,0,0,16,12,7,7,32.0,68.0,1,17,3,20,2,0,28,14
2618,4201,27,2014/2015,2015-04-29 00:00:00,Leicester City,Chelsea,1,3,5.75,3.8,1.7,2,5,5,6,10,1,1,0,0,0,23,23,2,6,38.0,62.0,4,7,11,11,1,0,46,8
2619,4289,35,2014/2015,2015-05-02 00:00:00,Aston Villa,Everton,3,2,2.75,3.3,2.8,3,4,4,3,13,12,2,1,0,0,15,12,5,3,51.0,49.0,5,7,7,25,3,0,27,8
2620,4292,35,2014/2015,2015-05-02 00:00:00,Leicester City,Newcastle United,3,0,1.91,3.7,4.33,7,5,9,8,10,13,1,4,0,0,22,13,10,7,47.0,53.0,3,12,17,23,5,0,35,17
2621,4293,35,2014/2015,2015-05-02 00:00:00,Liverpool,Queens Park Rangers,2,1,1.36,5.25,10.0,10,3,10,7,9,18,2,4,0,0,22,19,9,6,63.0,37.0,3,13,17,27,6,0,41,15
2622,4294,35,2014/2015,2015-05-02 00:00:00,Manchester United,West Bromwich Albion,0,1,1.36,5.25,10.0,15,3,7,3,10,11,1,0,0,0,30,6,9,3,80.0,20.0,1,18,10,21,1,0,36,12
2623,4295,35,2014/2015,2015-05-02 00:00:00,Sunderland,Southampton,2,1,4.2,3.4,2.05,6,3,3,5,12,13,2,2,0,1,12,15,1,1,44.0,56.0,3,9,8,25,4,1,27,2
2624,4296,35,2014/2015,2015-05-02 00:00:00,Swansea City,Stoke City,2,0,2.3,3.4,3.4,5,4,6,3,9,19,1,3,0,0,14,9,6,2,47.0,53.0,2,9,9,28,4,0,23,8
2625,4298,35,2014/2015,2015-05-02 00:00:00,West Ham United,Burnley,1,0,2.25,3.5,3.4,14,4,9,4,11,8,3,2,0,1,33,18,13,3,60.0,40.0,1,18,13,19,5,1,51,16
2626,4290,35,2014/2015,2015-05-03 00:00:00,Chelsea,Crystal Palace,1,0,1.36,5.25,10.0,8,4,8,3,12,13,2,2,0,0,12,22,3,6,63.0,37.0,1,12,11,25,4,0,34,9
2627,4297,35,2014/2015,2015-05-03 00:00:00,Tottenham Hotspur,Manchester City,0,1,3.75,3.75,2.05,10,9,7,5,6,11,3,4,0,0,26,16,8,7,55.0,45.0,1,19,12,17,7,0,42,15
2628,4291,35,2014/2015,2015-05-04 00:00:00,Hull City,Arsenal,1,3,5.5,4.0,1.7,2,13,4,8,8,11,2,0,0,0,21,14,0,5,32.0,68.0,4,15,12,19,2,0,35,5
2629,4300,36,2014/2015,2015-05-09 00:00:00,Aston Villa,West Ham United,1,0,1.91,3.7,4.33,6,3,7,3,6,13,1,1,0,0,28,13,2,6,59.0,41.0,1,9,10,19,2,0,41,8
2630,4302,36,2014/2015,2015-05-09 00:00:00,Crystal Palace,Manchester United,1,2,4.5,3.6,1.91,5,7,5,4,13,12,0,1,0,0,31,13,7,6,38.0,62.0,3,12,9,25,1,0,44,13
2631,4303,36,2014/2015,2015-05-09 00:00:00,Everton,Sunderland,0,2,1.8,3.75,5.0,14,4,9,4,10,9,2,3,0,0,22,9,15,1,73.0,27.0,2,18,13,19,5,0,31,16
2632,4304,36,2014/2015,2015-05-09 00:00:00,Hull City,Burnley,0,1,1.95,3.5,4.5,13,2,7,4,15,13,1,1,0,0,26,15,9,3,54.0,46.0,1,15,11,28,2,0,41,12
2633,4305,36,2014/2015,2015-05-09 00:00:00,Leicester City,Southampton,2,0,2.6,3.4,2.9,3,5,4,5,12,10,1,0,0,0,12,19,4,8,30.0,70.0,2,8,9,22,1,0,31,12
2634,4307,36,2014/2015,2015-05-09 00:00:00,Newcastle United,West Bromwich Albion,1,1,2.55,3.3,3.0,5,3,9,3,11,17,2,3,0,0,25,10,7,2,60.0,40.0,2,8,12,28,5,0,35,9
2635,4308,36,2014/2015,2015-05-09 00:00:00,Stoke City,Tottenham Hotspur,3,0,2.9,3.4,2.6,11,6,3,3,14,12,0,1,0,0,29,21,6,8,45.0,55.0,3,17,6,26,1,0,50,14
2636,4301,36,2014/2015,2015-05-10 00:00:00,Chelsea,Liverpool,1,1,2.1,3.5,3.8,4,5,3,10,14,11,4,3,0,0,9,15,6,4,48.0,52.0,2,9,13,25,7,0,24,10
2637,4306,36,2014/2015,2015-05-10 00:00:00,Manchester City,Queens Park Rangers,6,0,1.22,7.5,13.0,9,4,6,5,12,7,0,1,0,0,17,19,7,4,60.0,40.0,6,13,11,19,1,0,36,11
2638,4299,36,2014/2015,2015-05-11 00:00:00,Arsenal,Swansea City,0,1,1.3,6.0,11.0,20,4,5,3,7,10,0,1,0,0,22,8,6,1,67.0,33.0,1,24,8,17,1,0,30,7
2639,4309,37,2014/2015,2015-05-16 00:00:00,Burnley,Stoke City,0,0,2.7,3.3,2.88,6,5,1,5,14,9,1,2,0,0,20,22,7,6,45.0,55.0,0,11,6,23,3,0,42,13
2640,4310,37,2014/2015,2015-05-16 00:00:00,Liverpool,Crystal Palace,1,3,1.45,4.75,8.0,8,5,8,7,10,18,2,3,0,0,12,12,4,5,66.0,34.0,4,13,15,28,5,0,24,9
2641,4312,37,2014/2015,2015-05-16 00:00:00,Queens Park Rangers,Newcastle United,2,1,3.1,3.5,2.4,3,17,3,6,12,8,2,0,0,0,19,15,3,12,47.0,53.0,3,20,9,20,2,0,34,15
2642,4313,37,2014/2015,2015-05-16 00:00:00,Southampton,Aston Villa,6,1,1.75,3.8,5.25,9,4,3,4,19,7,1,1,0,0,13,25,6,3,36.0,64.0,7,13,7,26,2,0,38,9
2643,4314,37,2014/2015,2015-05-16 00:00:00,Sunderland,Leicester City,0,0,2.8,3.3,2.75,7,4,4,5,14,15,4,1,0,0,10,21,8,9,51.0,49.0,0,11,9,29,5,0,31,17
2644,4316,37,2014/2015,2015-05-16 00:00:00,Tottenham Hotspur,Hull City,2,0,1.8,3.8,4.75,2,4,7,8,10,6,3,1,0,0,16,26,6,8,55.0,45.0,2,6,15,16,4,0,42,14
2645,4318,37,2014/2015,2015-05-16 00:00:00,West Ham United,Everton,1,2,2.9,3.4,2.6,7,8,5,9,13,14,1,4,0,0,21,11,7,8,46.0,54.0,3,15,14,27,5,0,32,15
2646,4311,37,2014/2015,2015-05-17 00:00:00,Manchester United,Arsenal,1,1,2.45,3.5,3.0,7,4,6,2,16,8,1,0,0,0,18,14,5,5,58.0,42.0,2,11,8,24,1,0,32,10
2647,4315,37,2014/2015,2015-05-17 00:00:00,Swansea City,Manchester City,2,4,4.75,4.2,1.75,7,11,3,6,8,8,0,3,0,0,11,9,11,7,47.0,53.0,6,18,9,16,3,0,20,18
2648,4317,37,2014/2015,2015-05-18 00:00:00,West Bromwich Albion,Chelsea,3,0,4.1,3.5,2.0,3,7,3,5,12,11,3,2,0,1,11,15,3,4,41.0,59.0,3,10,8,23,5,1,26,7
2649,4269,33,2014/2015,2015-05-20 00:00:00,Arsenal,Sunderland,0,0,1.3,6.0,11.0,17,4,10,3,6,8,1,0,0,0,32,4,5,2,74.0,26.0,0,21,13,14,1,0,36,7
2650,4319,38,2014/2015,2015-05-24 00:00:00,Arsenal,West Bromwich Albion,4,1,1.4,5.25,8.5,11,7,8,8,6,7,1,0,0,0,7,8,7,3,64.0,36.0,5,18,16,13,1,0,15,10
2651,4320,38,2014/2015,2015-05-24 00:00:00,Aston Villa,Burnley,0,1,2.1,3.6,3.75,7,4,10,2,11,6,1,2,0,0,27,10,7,2,63.0,37.0,1,11,12,17,3,0,37,9
2652,4321,38,2014/2015,2015-05-24 00:00:00,Chelsea,Sunderland,3,1,1.36,5.25,9.5,12,9,7,6,12,8,2,1,0,0,31,4,11,3,64.0,36.0,4,21,13,20,3,0,35,14
2653,4322,38,2014/2015,2015-05-24 00:00:00,Crystal Palace,Swansea City,1,0,2.25,3.6,3.3,9,3,2,1,23,13,3,0,0,0,21,12,7,3,50.0,50.0,1,12,3,36,3,0,33,10
2654,4323,38,2014/2015,2015-05-24 00:00:00,Everton,Tottenham Hotspur,0,1,2.4,3.6,3.0,3,10,9,4,12,7,1,2,0,0,13,6,3,5,40.0,60.0,1,13,13,19,3,0,19,8
2655,4324,38,2014/2015,2015-05-24 00:00:00,Hull City,Manchester United,0,0,3.2,3.75,2.25,8,4,5,3,12,15,2,2,0,1,19,6,8,1,40.0,60.0,0,12,8,27,4,1,25,9
2656,4325,38,2014/2015,2015-05-24 00:00:00,Leicester City,Queens Park Rangers,5,1,1.6,4.33,6.0,3,6,9,8,7,6,0,0,0,0,18,16,5,6,47.0,53.0,6,9,17,13,0,0,34,11
2657,4326,38,2014/2015,2015-05-24 00:00:00,Manchester City,Southampton,2,0,1.57,4.5,6.0,7,8,8,6,13,8,1,1,0,0,11,18,8,4,55.0,45.0,2,15,14,21,2,0,29,12
2658,4327,38,2014/2015,2015-05-24 00:00:00,Newcastle United,West Ham United,2,0,1.83,4.0,4.33,4,1,10,3,9,9,2,1,0,0,29,19,2,3,41.0,59.0,2,5,13,18,3,0,48,5
2659,4328,38,2014/2015,2015-05-24 00:00:00,Stoke City,Liverpool,6,1,3.5,3.6,2.15,5,8,4,6,14,4,4,2,0,0,9,11,3,9,45.0,55.0,7,13,10,18,6,0,20,12
2660,4390,1,2015/2016,2015-08-08 00:00:00,Bournemouth,Aston Villa,0,1,2.0,3.6,4.0,5,4,8,2,13,13,3,3,0,0,19,15,6,3,57.0,43.0,1,9,10,26,6,0,34,9
2661,4391,1,2015/2016,2015-08-08 00:00:00,Chelsea,Swansea City,2,2,1.36,5.0,11.0,7,13,4,2,15,16,1,3,1,0,10,10,4,8,53.0,47.0,4,20,6,31,4,1,20,12
2662,4392,1,2015/2016,2015-08-08 00:00:00,Everton,Watford,2,2,1.7,3.9,5.5,4,6,5,3,7,14,1,2,0,0,23,11,8,2,67.0,33.0,4,10,8,21,3,0,34,10
2663,4393,1,2015/2016,2015-08-08 00:00:00,Leicester City,Sunderland,4,2,1.95,3.5,4.33,8,5,9,4,13,17,2,4,0,0,16,10,6,3,44.0,56.0,6,13,13,30,6,0,26,9
2664,4394,1,2015/2016,2015-08-08 00:00:00,Manchester United,Tottenham Hotspur,1,0,1.65,4.0,6.0,6,6,4,2,12,12,2,3,0,0,8,11,1,2,51.0,49.0,1,12,6,24,5,0,19,3
2665,4396,1,2015/2016,2015-08-08 00:00:00,Norwich City,Crystal Palace,1,3,2.55,3.3,3.0,7,6,8,1,14,20,1,0,0,0,18,18,1,4,63.0,37.0,4,13,9,34,1,0,36,5
2666,4389,1,2015/2016,2015-08-09 00:00:00,Arsenal,West Ham United,0,2,1.29,6.0,12.0,15,5,8,2,12,9,1,3,0,0,28,7,5,4,62.0,38.0,2,20,10,21,4,0,35,9
2667,4395,1,2015/2016,2015-08-09 00:00:00,Newcastle United,Southampton,2,2,2.88,3.3,2.7,4,5,3,8,9,12,2,4,0,0,17,11,6,6,56.0,44.0,4,9,11,21,6,0,28,12
2668,4397,1,2015/2016,2015-08-09 00:00:00,Stoke City,Liverpool,0,1,3.4,3.4,2.3,5,8,2,3,10,16,2,4,0,0,18,11,3,5,47.0,53.0,1,13,5,26,6,0,29,8
2669,4398,1,2015/2016,2015-08-10 00:00:00,West Bromwich Albion,Manchester City,0,3,5.75,4.0,1.67,5,11,5,3,12,9,4,1,0,0,16,16,6,6,33.0,67.0,3,16,8,21,5,0,32,12
2670,4499,2,2015/2016,2015-08-14 00:00:00,Aston Villa,Manchester United,0,1,5.5,3.8,1.73,2,3,3,5,14,10,2,2,0,0,12,6,3,5,46.0,54.0,1,5,8,24,4,0,18,8
2671,4503,2,2015/2016,2015-08-15 00:00:00,Southampton,Everton,0,3,1.95,3.6,4.33,9,5,6,2,13,10,4,2,0,0,30,10,9,9,55.0,45.0,3,14,8,23,6,0,40,18
2672,4504,2,2015/2016,2015-08-15 00:00:00,Sunderland,Norwich City,1,3,2.5,3.3,3.1,2,9,3,4,7,7,1,2,0,0,9,15,6,6,45.0,55.0,4,11,7,14,3,0,24,12
2673,4505,2,2015/2016,2015-08-15 00:00:00,Swansea City,Newcastle United,2,0,1.95,3.6,4.33,9,2,7,2,11,9,2,2,0,0,14,8,4,4,67.0,33.0,2,11,9,20,4,0,22,8
2674,4506,2,2015/2016,2015-08-15 00:00:00,Tottenham Hotspur,Stoke City,2,2,1.8,3.75,5.0,10,7,3,6,17,11,2,2,0,0,11,19,4,3,52.0,48.0,4,17,9,28,4,0,30,7
2675,4507,2,2015/2016,2015-08-15 00:00:00,Watford,West Bromwich Albion,0,0,2.3,3.4,3.4,10,1,7,4,13,10,1,2,0,0,22,10,2,4,65.0,35.0,0,11,11,23,3,0,32,6
2676,4508,2,2015/2016,2015-08-15 00:00:00,West Ham United,Leicester City,1,2,2.25,3.5,3.4,6,5,4,4,11,12,1,3,1,0,20,10,8,4,68.0,32.0,3,11,8,23,4,1,30,12
2677,4500,2,2015/2016,2015-08-16 00:00:00,Crystal Palace,Arsenal,1,2,5.25,3.9,1.73,6,14,3,4,14,12,1,1,0,0,30,17,6,6,41.0,59.0,3,20,7,26,2,0,47,12
2678,4502,2,2015/2016,2015-08-16 00:00:00,Manchester City,Chelsea,3,0,2.1,3.5,3.75,9,7,7,3,19,13,4,2,0,0,18,21,5,1,49.0,51.0,3,16,10,32,6,0,39,6
2679,4501,2,2015/2016,2015-08-17 00:00:00,Liverpool,Bournemouth,1,0,1.45,4.75,8.0,4,5,13,7,11,19,1,4,0,0,14,22,6,8,56.0,44.0,1,9,20,30,5,0,36,14
2680,4610,3,2015/2016,2015-08-22 00:00:00,Crystal Palace,Aston Villa,2,1,1.85,3.6,4.75,9,6,6,7,13,14,3,3,0,0,18,18,6,4,50.0,50.0,3,15,13,27,6,0,36,10
2681,4612,3,2015/2016,2015-08-22 00:00:00,Leicester City,Tottenham Hotspur,1,1,2.63,3.6,2.75,5,8,5,10,7,14,1,4,0,0,20,12,2,7,35.0,65.0,2,13,15,21,5,0,32,9
2682,4613,3,2015/2016,2015-08-22 00:00:00,Manchester United,Newcastle United,0,0,1.36,5.25,10.0,16,3,4,3,15,11,2,2,0,0,29,12,11,5,69.0,31.0,0,19,7,26,4,0,41,16
2683,4614,3,2015/2016,2015-08-22 00:00:00,Norwich City,Stoke City,1,1,2.3,3.3,3.5,10,2,10,5,16,5,4,1,0,0,15,9,9,0,42.0,58.0,2,12,15,21,5,0,24,9
2684,4615,3,2015/2016,2015-08-22 00:00:00,Sunderland,Swansea City,1,1,4.0,3.4,2.1,6,12,5,7,16,9,4,2,0,0,14,19,3,4,39.0,61.0,2,18,12,25,6,0,33,7
2685,4618,3,2015/2016,2015-08-22 00:00:00,West Ham United,Bournemouth,3,4,2.38,3.4,3.2,5,4,2,6,8,11,0,1,1,0,11,13,5,4,46.0,54.0,7,9,8,19,1,1,24,9
2686,4611,3,2015/2016,2015-08-23 00:00:00,Everton,Manchester City,0,2,5.0,4.0,1.73,4,10,7,5,5,7,0,3,0,0,13,21,8,7,45.0,55.0,2,14,12,12,3,0,34,15
2687,4616,3,2015/2016,2015-08-23 00:00:00,Watford,Southampton,0,0,2.8,3.3,2.75,6,7,6,8,11,11,0,2,0,0,25,17,5,2,51.0,49.0,0,13,14,22,2,0,42,7
2688,4617,3,2015/2016,2015-08-23 00:00:00,West Bromwich Albion,Chelsea,2,3,6.5,4.0,1.62,6,3,6,8,9,12,2,1,0,1,21,10,8,7,44.0,56.0,5,9,14,21,3,1,31,15
2689,4609,3,2015/2016,2015-08-24 00:00:00,Arsenal,Liverpool,0,0,1.75,4.0,5.0,10,8,7,7,2,13,1,4,0,0,20,11,7,8,66.0,34.0,0,18,14,15,5,0,31,15
2690,4709,4,2015/2016,2015-08-29 00:00:00,Aston Villa,Sunderland,2,2,1.91,3.5,4.75,10,2,11,2,10,14,2,1,0,0,27,12,5,4,62.0,38.0,4,12,13,24,3,0,39,9
2691,4710,4,2015/2016,2015-08-29 00:00:00,Bournemouth,Leicester City,1,1,2.2,3.6,3.4,1,1,2,3,9,19,2,4,0,0,12,14,4,4,57.0,43.0,2,2,5,28,6,0,26,8
2692,4711,4,2015/2016,2015-08-29 00:00:00,Chelsea,Crystal Palace,1,2,1.36,5.0,11.0,17,4,10,5,9,15,1,1,0,0,23,14,7,7,64.0,36.0,3,21,15,24,2,0,37,14
2693,4712,4,2015/2016,2015-08-29 00:00:00,Liverpool,West Ham United,0,3,1.36,5.5,9.0,5,4,6,4,18,11,4,2,0,1,18,11,5,7,64.0,36.0,3,9,10,29,6,1,29,12
2694,4713,4,2015/2016,2015-08-29 00:00:00,Manchester City,Watford,2,0,1.2,8.0,15.0,8,4,8,3,9,12,1,2,0,0,20,13,9,3,60.0,40.0,2,12,11,21,3,0,33,12
2695,4714,4,2015/2016,2015-08-29 00:00:00,Newcastle United,Arsenal,0,1,6.0,4.2,1.62,0,16,1,6,16,8,6,1,1,0,8,12,0,9,26.0,74.0,1,16,7,24,7,1,20,9
2696,4716,4,2015/2016,2015-08-29 00:00:00,Stoke City,West Bromwich Albion,0,1,1.95,3.4,4.5,7,8,6,7,4,9,1,4,2,0,10,22,6,5,49.0,51.0,1,15,13,13,5,2,32,11
2697,4718,4,2015/2016,2015-08-29 00:00:00,Tottenham Hotspur,Everton,0,0,2.0,3.5,4.2,12,4,7,5,21,9,4,1,0,0,26,14,6,2,50.0,50.0,0,16,12,30,5,0,40,8
2698,4715,4,2015/2016,2015-08-30 00:00:00,Southampton,Norwich City,3,0,2.05,3.5,4.0,10,3,12,4,4,13,0,1,0,0,27,8,6,4,62.0,38.0,3,13,16,17,1,0,35,10
2699,4717,4,2015/2016,2015-08-30 00:00:00,Swansea City,Manchester United,2,1,3.6,3.3,2.25,3,5,4,5,6,15,2,2,0,0,7,25,0,1,36.0,64.0,3,8,9,21,4,0,32,1
2700,4719,5,2015/2016,2015-09-12 00:00:00,Arsenal,Stoke City,2,0,1.29,6.0,12.0,17,5,11,1,6,13,1,1,0,0,15,7,13,1,69.0,31.0,2,22,12,19,2,0,22,14
2701,4720,5,2015/2016,2015-09-12 00:00:00,Crystal Palace,Manchester City,0,1,5.5,4.2,1.67,4,11,8,9,13,13,2,3,0,0,15,12,4,4,41.0,59.0,1,15,17,26,5,0,27,8
2702,4721,5,2015/2016,2015-09-12 00:00:00,Everton,Chelsea,3,1,4.0,3.6,2.0,6,5,6,8,12,12,2,2,0,0,12,23,7,14,39.0,61.0,4,11,14,24,4,0,35,21
2703,4723,5,2015/2016,2015-09-12 00:00:00,Manchester United,Liverpool,3,1,2.0,3.4,4.33,3,3,3,4,6,11,1,2,0,0,15,7,4,4,56.0,44.0,4,6,7,17,3,0,22,8
2704,4724,5,2015/2016,2015-09-12 00:00:00,Norwich City,Bournemouth,3,1,2.4,3.4,3.2,2,2,9,4,10,11,2,3,0,0,16,15,4,4,47.0,53.0,4,4,13,21,5,0,31,8
2705,4726,5,2015/2016,2015-09-12 00:00:00,Watford,Swansea City,1,0,2.75,3.4,2.75,8,4,6,3,11,14,1,1,1,0,10,17,1,3,41.0,59.0,1,12,9,25,2,1,27,4
2706,4727,5,2015/2016,2015-09-12 00:00:00,West Bromwich Albion,Southampton,0,0,3.2,3.2,2.5,2,9,5,2,5,5,1,0,0,0,12,27,4,5,35.0,65.0,0,11,7,10,1,0,39,9
2707,4722,5,2015/2016,2015-09-13 00:00:00,Leicester City,Aston Villa,3,2,1.91,3.75,4.33,7,6,12,3,8,13,2,1,0,0,19,6,4,5,48.0,52.0,5,13,15,21,3,0,25,9
2708,4725,5,2015/2016,2015-09-13 00:00:00,Sunderland,Tottenham Hotspur,0,1,4.33,3.6,1.95,7,8,7,10,11,12,2,1,0,0,17,13,6,8,43.0,57.0,1,15,17,23,3,0,30,14
2709,4728,5,2015/2016,2015-09-14 00:00:00,West Ham United,Newcastle United,2,0,2.25,3.5,3.4,6,8,7,6,8,11,0,2,0,0,15,25,6,7,39.0,61.0,2,14,13,19,2,0,40,13
2710,4729,6,2015/2016,2015-09-19 00:00:00,Aston Villa,West Bromwich Albion,0,1,2.3,3.25,3.5,9,7,5,3,10,12,2,3,0,0,30,18,2,7,60.0,40.0,1,16,8,22,5,0,48,9
2711,4730,6,2015/2016,2015-09-19 00:00:00,Bournemouth,Sunderland,2,0,1.7,4.0,5.5,10,6,4,4,14,15,2,5,0,0,14,16,7,3,53.0,47.0,2,16,8,29,7,0,30,10
2712,4731,6,2015/2016,2015-09-19 00:00:00,Chelsea,Arsenal,2,0,2.45,3.5,3.0,16,4,6,4,12,11,3,3,0,1,12,12,5,5,62.0,38.0,2,20,10,23,6,1,24,10
2713,4733,6,2015/2016,2015-09-19 00:00:00,Manchester City,West Ham United,1,2,1.29,6.5,11.0,14,2,10,2,10,7,1,2,0,0,44,5,16,3,72.0,28.0,3,16,12,17,3,0,49,19
2714,4734,6,2015/2016,2015-09-19 00:00:00,Newcastle United,Watford,1,2,2.5,3.3,3.1,8,5,7,6,8,12,1,2,0,0,32,8,5,5,58.0,42.0,3,13,13,20,3,0,40,10
2715,4736,6,2015/2016,2015-09-19 00:00:00,Stoke City,Leicester City,2,2,2.5,3.4,3.0,2,3,5,6,7,12,1,4,0,0,24,12,3,4,54.0,46.0,4,5,11,19,5,0,36,7
2716,4737,6,2015/2016,2015-09-19 00:00:00,Swansea City,Everton,0,0,2.3,3.4,3.4,8,9,6,7,12,11,2,2,0,1,17,14,2,4,47.0,53.0,0,17,13,23,4,1,31,6
2717,4732,6,2015/2016,2015-09-20 00:00:00,Liverpool,Norwich City,1,1,1.67,4.0,5.75,14,3,7,4,4,13,1,2,0,0,21,10,6,2,60.0,40.0,2,17,11,17,3,0,31,8
2718,4735,6,2015/2016,2015-09-20 00:00:00,Southampton,Manchester United,2,3,3.1,3.3,2.5,7,1,5,6,6,13,2,0,0,0,21,6,5,5,41.0,59.0,5,8,11,19,2,0,27,10
2719,4738,6,2015/2016,2015-09-20 00:00:00,Tottenham Hotspur,Crystal Palace,1,0,2.0,3.6,4.0,11,8,8,5,9,11,1,2,0,0,12,14,6,5,58.0,42.0,1,19,13,20,3,0,26,11
2720,4739,7,2015/2016,2015-09-26 00:00:00,Leicester City,Arsenal,2,5,4.5,4.0,1.8,8,15,6,7,9,12,1,1,0,0,25,8,6,5,41.0,59.0,7,23,13,21,2,0,33,11
2721,4740,7,2015/2016,2015-09-26 00:00:00,Liverpool,Aston Villa,3,2,1.53,4.33,7.0,17,3,2,5,10,14,0,0,0,0,18,10,11,1,62.0,38.0,5,20,7,24,0,0,28,12
2722,4741,7,2015/2016,2015-09-26 00:00:00,Manchester United,Sunderland,3,0,1.2,7.5,16.0,8,7,4,1,12,17,0,3,0,0,12,5,5,2,66.0,34.0,3,15,5,29,3,0,17,7
2723,4742,7,2015/2016,2015-09-26 00:00:00,Newcastle United,Chelsea,2,2,6.0,4.2,1.62,6,5,3,11,13,14,1,2,0,0,15,30,4,6,36.0,64.0,4,11,14,27,3,0,45,10
2724,4743,7,2015/2016,2015-09-26 00:00:00,Southampton,Swansea City,3,1,2.05,3.4,4.2,7,8,7,5,18,14,3,1,0,0,23,14,4,3,42.0,58.0,4,15,12,32,4,0,37,7
2725,4744,7,2015/2016,2015-09-26 00:00:00,Stoke City,Bournemouth,2,1,2.55,3.3,3.0,4,8,3,2,12,11,1,0,0,0,12,13,3,7,43.0,57.0,3,12,5,23,1,0,25,10
2726,4745,7,2015/2016,2015-09-26 00:00:00,Tottenham Hotspur,Manchester City,4,1,4.2,3.8,1.91,7,15,3,8,17,6,5,1,0,0,16,14,5,9,47.0,53.0,5,22,11,23,6,0,30,14
2727,4748,7,2015/2016,2015-09-26 00:00:00,West Ham United,Norwich City,2,2,2.25,3.5,3.4,8,7,5,3,6,16,0,0,0,0,10,8,7,5,43.0,57.0,4,15,8,22,0,0,18,12
2728,4746,7,2015/2016,2015-09-27 00:00:00,Watford,Crystal Palace,0,1,2.5,3.3,3.1,7,8,7,5,17,22,4,4,0,0,27,22,6,4,55.0,45.0,1,15,12,39,8,0,49,10
2729,4747,7,2015/2016,2015-09-28 00:00:00,West Bromwich Albion,Everton,2,3,3.1,3.3,2.5,3,5,4,4,9,8,0,3,0,0,13,11,6,4,46.0,54.0,5,8,8,17,3,0,24,10
2730,4750,8,2015/2016,2015-10-03 00:00:00,Aston Villa,Stoke City,0,1,2.5,3.3,3.1,8,7,4,1,13,12,1,0,0,0,27,7,9,5,55.0,45.0,1,15,5,25,1,0,34,14
2731,4751,8,2015/2016,2015-10-03 00:00:00,Bournemouth,Watford,1,1,2.1,3.5,3.8,8,5,3,5,8,13,1,1,0,0,19,11,5,3,54.0,46.0,2,13,8,21,2,0,30,8
2732,4752,8,2015/2016,2015-10-03 00:00:00,Chelsea,Southampton,1,3,1.83,3.7,4.8,6,7,4,4,14,14,2,5,0,0,17,12,4,6,59.0,41.0,4,13,8,28,7,0,29,10
2733,4753,8,2015/2016,2015-10-03 00:00:00,Crystal Palace,West Bromwich Albion,2,0,1.83,3.6,5.0,15,4,4,2,14,13,3,3,0,0,22,9,8,3,60.0,40.0,2,19,6,27,6,0,31,11
2734,4755,8,2015/2016,2015-10-03 00:00:00,Manchester City,Newcastle United,6,1,1.25,7.0,13.0,11,4,7,1,13,8,3,1,0,0,21,12,6,3,64.0,36.0,7,15,8,21,4,0,33,9
2735,4756,8,2015/2016,2015-10-03 00:00:00,Norwich City,Leicester City,1,2,2.3,3.5,3.3,5,7,7,8,4,4,0,1,0,0,23,13,16,8,66.0,34.0,3,12,15,8,1,0,36,24
2736,4757,8,2015/2016,2015-10-03 00:00:00,Sunderland,West Ham United,2,2,3.2,3.4,2.4,4,9,6,8,16,12,3,4,0,0,6,19,1,8,44.0,56.0,4,13,14,28,7,0,25,9
2737,4749,8,2015/2016,2015-10-04 00:00:00,Arsenal,Manchester United,3,0,2.0,3.8,3.8,4,5,5,3,8,17,1,3,0,0,5,22,3,6,38.0,62.0,3,9,8,25,4,0,27,9
2738,4754,8,2015/2016,2015-10-04 00:00:00,Everton,Liverpool,1,1,2.7,3.4,2.8,10,5,3,6,10,19,3,3,0,0,13,17,5,11,50.0,50.0,2,15,9,29,6,0,30,16
2739,4758,8,2015/2016,2015-10-04 00:00:00,Swansea City,Tottenham Hotspur,2,2,2.75,3.25,2.8,6,14,4,5,8,19,1,4,0,0,18,20,5,6,45.0,55.0,4,20,9,27,5,0,38,11
2740,4759,9,2015/2016,2015-10-17 00:00:00,Chelsea,Aston Villa,2,0,1.33,5.75,10.0,5,4,4,6,22,17,1,3,0,0,14,11,4,4,49.0,51.0,2,9,10,39,4,0,25,8
2741,4760,9,2015/2016,2015-10-17 00:00:00,Crystal Palace,West Ham United,1,3,2.0,3.6,4.0,3,10,1,11,9,11,2,3,0,0,11,14,1,9,38.0,62.0,4,13,12,20,5,0,25,10
2742,4761,9,2015/2016,2015-10-17 00:00:00,Everton,Manchester United,0,3,3.25,3.4,2.38,10,6,7,2,12,14,2,2,0,0,11,15,5,3,47.0,53.0,3,16,9,26,4,0,26,8
2743,4762,9,2015/2016,2015-10-17 00:00:00,Manchester City,Bournemouth,5,1,1.33,5.75,10.0,6,2,5,4,11,5,2,1,0,0,9,21,1,7,55.0,45.0,6,8,9,16,3,0,30,8
2744,4764,9,2015/2016,2015-10-17 00:00:00,Southampton,Leicester City,2,2,1.75,4.0,5.0,3,9,6,10,16,10,2,0,0,0,10,21,6,7,51.0,49.0,4,12,16,26,2,0,31,13
2745,4766,9,2015/2016,2015-10-17 00:00:00,Tottenham Hotspur,Liverpool,0,0,2.5,3.5,3.0,8,8,5,2,15,11,1,2,0,0,12,10,8,6,49.0,51.0,0,16,7,26,3,0,22,14
2746,4767,9,2015/2016,2015-10-17 00:00:00,Watford,Arsenal,0,3,6.0,4.2,1.62,4,11,5,4,11,12,2,1,0,0,14,13,3,9,33.0,67.0,3,15,9,23,3,0,27,12
2747,4768,9,2015/2016,2015-10-17 00:00:00,West Bromwich Albion,Sunderland,1,0,2.05,3.4,4.2,4,4,4,4,13,13,2,2,0,0,25,18,1,5,57.0,43.0,1,8,8,26,4,0,43,6
2748,4763,9,2015/2016,2015-10-18 00:00:00,Newcastle United,Norwich City,6,2,2.6,3.4,2.88,2,11,2,6,10,10,1,1,0,0,14,21,3,7,44.0,56.0,8,13,8,20,2,0,35,10
2749,4765,9,2015/2016,2015-10-19 00:00:00,Swansea City,Stoke City,0,1,2.05,3.4,4.2,4,2,9,6,6,14,2,2,0,0,19,6,1,2,54.0,46.0,1,6,15,20,4,0,25,3
2750,4399,10,2015/2016,2015-10-24 00:00:00,Arsenal,Everton,2,1,1.44,4.75,8.0,9,5,9,4,11,13,2,1,0,0,17,13,7,5,56.0,44.0,3,14,13,24,3,0,30,12
2751,4400,10,2015/2016,2015-10-24 00:00:00,Aston Villa,Swansea City,1,2,3.0,3.3,2.6,4,3,4,5,10,8,2,3,0,0,18,10,4,6,48.0,52.0,3,7,9,18,5,0,28,10
2752,4402,10,2015/2016,2015-10-24 00:00:00,Leicester City,Crystal Palace,1,0,2.2,3.6,3.4,5,5,6,3,8,10,3,1,0,0,17,17,3,2,48.0,52.0,1,10,9,18,4,0,34,5
2753,4405,10,2015/2016,2015-10-24 00:00:00,Norwich City,West Bromwich Albion,0,1,2.0,3.5,4.2,5,3,9,2,11,6,1,2,0,0,25,16,13,3,61.0,39.0,1,8,11,17,3,0,41,16
2754,4406,10,2015/2016,2015-10-24 00:00:00,Stoke City,Watford,0,2,2.1,3.3,4.0,2,7,9,5,10,18,3,1,0,0,17,6,11,5,67.0,33.0,2,9,14,28,4,0,23,16
2755,4408,10,2015/2016,2015-10-24 00:00:00,West Ham United,Chelsea,2,1,4.0,3.8,1.95,6,5,3,5,10,12,1,6,0,0,21,11,7,4,45.0,55.0,3,11,8,22,7,0,32,11
2756,4401,10,2015/2016,2015-10-25 00:00:00,Bournemouth,Tottenham Hotspur,1,5,3.4,3.5,2.25,4,7,5,2,8,15,0,1,0,0,20,14,4,5,45.0,55.0,6,11,7,23,1,0,34,9
2757,4403,10,2015/2016,2015-10-25 00:00:00,Liverpool,Southampton,1,1,2.05,3.6,3.8,6,4,9,4,9,11,1,1,0,0,13,14,10,7,60.0,40.0,2,10,13,20,2,0,27,17
2758,4404,10,2015/2016,2015-10-25 00:00:00,Manchester United,Manchester City,0,0,2.6,3.5,2.8,1,3,3,4,17,13,2,2,0,0,21,9,6,4,60.0,40.0,0,4,7,30,4,0,30,10
2759,4407,10,2015/2016,2015-10-25 00:00:00,Sunderland,Newcastle United,3,0,2.6,3.4,2.9,4,13,3,6,12,10,0,2,0,1,14,19,1,10,39.0,61.0,3,17,9,22,2,1,33,11
2760,4409,11,2015/2016,2015-10-31 00:00:00,Chelsea,Liverpool,1,3,2.1,3.5,3.75,5,8,1,5,9,21,1,4,0,0,14,13,1,7,43.0,57.0,4,13,6,30,5,0,27,8
2761,4410,11,2015/2016,2015-10-31 00:00:00,Crystal Palace,Manchester United,0,0,3.8,3.5,2.1,9,3,6,2,12,15,3,3,0,0,17,15,7,3,45.0,55.0,0,12,8,27,6,0,32,10
2762,4412,11,2015/2016,2015-10-31 00:00:00,Manchester City,Norwich City,2,1,1.29,6.0,12.0,8,4,7,1,4,13,2,2,0,1,15,7,12,4,72.0,28.0,3,12,8,17,4,1,22,16
2763,4413,11,2015/2016,2015-10-31 00:00:00,Newcastle United,Stoke City,0,0,2.4,3.4,3.2,10,2,5,5,7,16,1,3,0,0,22,16,11,4,52.0,48.0,0,12,10,23,4,0,38,15
2764,4415,11,2015/2016,2015-10-31 00:00:00,Swansea City,Arsenal,0,3,5.0,4.0,1.75,7,3,1,7,12,6,2,0,0,0,16,12,4,4,54.0,46.0,3,10,8,18,2,0,28,8
2765,4417,11,2015/2016,2015-10-31 00:00:00,Watford,West Ham United,2,0,2.6,3.4,2.9,12,3,6,4,16,12,3,0,0,1,12,14,7,2,49.0,51.0,2,15,10,28,3,1,26,9
2766,4418,11,2015/2016,2015-10-31 00:00:00,West Bromwich Albion,Leicester City,2,3,2.9,3.4,2.6,7,5,4,5,3,11,0,2,0,0,19,19,6,4,46.0,54.0,5,12,9,14,2,0,38,10
2767,4411,11,2015/2016,2015-11-01 00:00:00,Everton,Sunderland,6,2,1.5,4.5,7.5,4,11,6,4,6,5,3,2,0,0,11,15,6,1,69.0,31.0,8,15,10,11,5,0,26,7
2768,4414,11,2015/2016,2015-11-01 00:00:00,Southampton,Bournemouth,2,0,1.55,4.33,6.5,3,6,7,10,5,5,1,2,0,0,15,12,4,6,49.0,51.0,2,9,17,10,3,0,27,10
2769,4416,11,2015/2016,2015-11-02 00:00:00,Tottenham Hotspur,Aston Villa,3,1,1.44,4.75,8.0,8,6,4,6,6,15,0,3,0,0,14,13,4,3,62.0,38.0,4,14,10,21,3,0,27,7
2770,4421,12,2015/2016,2015-11-07 00:00:00,Bournemouth,Newcastle United,0,1,2.25,3.5,3.4,12,0,10,1,9,11,2,2,0,0,26,4,16,0,68.0,32.0,1,12,11,20,4,0,30,16
2771,4422,12,2015/2016,2015-11-07 00:00:00,Leicester City,Watford,2,1,1.85,3.8,4.5,6,4,4,3,11,10,0,1,0,0,20,12,4,2,41.0,59.0,3,10,7,21,1,0,32,6
2772,4424,12,2015/2016,2015-11-07 00:00:00,Manchester United,West Bromwich Albion,2,0,1.33,5.25,12.0,5,1,6,2,11,10,1,3,0,1,19,12,5,1,70.0,30.0,2,6,8,21,4,1,31,6
2773,4425,12,2015/2016,2015-11-07 00:00:00,Norwich City,Swansea City,1,0,2.45,3.4,3.1,4,1,4,7,12,7,1,0,0,0,11,11,5,2,33.0,67.0,1,5,11,19,1,0,22,7
2774,4426,12,2015/2016,2015-11-07 00:00:00,Stoke City,Chelsea,1,0,3.8,3.6,2.05,2,9,5,9,13,10,3,1,0,0,13,19,1,9,37.0,63.0,1,11,14,23,4,0,32,10
2775,4427,12,2015/2016,2015-11-07 00:00:00,Sunderland,Southampton,0,1,4.75,3.8,1.8,2,7,4,4,10,11,1,3,0,0,15,16,3,7,34.0,66.0,1,9,8,21,4,0,31,10
2776,4428,12,2015/2016,2015-11-07 00:00:00,West Ham United,Everton,1,1,2.6,3.5,2.8,6,7,8,6,11,12,1,2,0,0,17,12,3,5,51.0,49.0,2,13,14,23,3,0,29,8
2777,4419,12,2015/2016,2015-11-08 00:00:00,Arsenal,Tottenham Hotspur,1,1,1.73,4.0,5.0,2,4,5,9,13,17,0,1,0,0,16,11,7,6,55.0,45.0,2,6,14,30,1,0,27,13
2778,4420,12,2015/2016,2015-11-08 00:00:00,Aston Villa,Manchester City,0,0,7.5,5.0,1.44,0,8,3,7,7,7,1,1,0,0,12,25,3,8,42.0,58.0,0,8,10,14,2,0,37,11
2779,4423,12,2015/2016,2015-11-08 00:00:00,Liverpool,Crystal Palace,1,2,1.67,3.8,6.0,12,3,9,3,7,7,1,2,0,0,21,8,14,6,63.0,37.0,3,15,12,14,3,0,29,20
2780,4429,13,2015/2016,2015-11-21 00:00:00,Chelsea,Norwich City,1,0,1.4,5.0,9.0,11,3,9,1,4,12,1,4,0,0,28,13,6,5,66.0,34.0,1,14,10,16,5,0,41,11
2781,4431,13,2015/2016,2015-11-21 00:00:00,Everton,Aston Villa,4,0,1.57,4.2,6.5,9,8,4,3,6,10,0,0,0,0,10,4,2,3,59.0,41.0,4,17,7,16,0,0,14,5
2782,4432,13,2015/2016,2015-11-21 00:00:00,Manchester City,Liverpool,1,4,1.7,4.0,5.5,5,9,5,2,7,13,0,3,0,0,19,4,11,5,59.0,41.0,5,14,7,20,3,0,23,16
2783,4433,13,2015/2016,2015-11-21 00:00:00,Newcastle United,Leicester City,0,3,2.88,3.6,2.5,6,9,4,5,9,12,4,1,0,0,17,14,4,9,54.0,46.0,3,15,9,21,5,0,31,13
2784,4434,13,2015/2016,2015-11-21 00:00:00,Southampton,Stoke City,0,1,1.57,4.0,7.0,4,4,11,10,8,8,2,0,0,0,26,7,7,3,59.0,41.0,1,8,21,16,2,0,33,10
2785,4435,13,2015/2016,2015-11-21 00:00:00,Swansea City,Bournemouth,2,2,1.91,3.6,4.5,7,6,2,8,7,9,3,2,0,0,14,14,4,5,43.0,57.0,4,13,10,16,5,0,28,9
2786,4437,13,2015/2016,2015-11-21 00:00:00,Watford,Manchester United,1,2,4.33,3.4,2.0,7,6,2,6,6,12,1,2,0,0,11,18,4,10,43.0,57.0,3,13,8,18,3,0,29,14
2787,4438,13,2015/2016,2015-11-21 00:00:00,West Bromwich Albion,Arsenal,2,1,7.0,4.33,1.53,1,6,2,7,14,10,3,2,0,0,17,29,3,5,27.0,73.0,3,7,9,24,5,0,46,8
2788,4436,13,2015/2016,2015-11-22 00:00:00,Tottenham Hotspur,West Ham United,4,1,1.57,4.2,6.5,11,2,8,6,14,9,2,2,0,0,11,16,7,6,56.0,44.0,5,13,14,23,4,0,27,13
2789,4430,13,2015/2016,2015-11-23 00:00:00,Crystal Palace,Sunderland,0,1,1.57,4.0,7.0,10,5,11,6,18,11,1,3,0,0,36,8,11,2,67.0,33.0,1,15,17,29,4,0,44,13
2790,4439,14,2015/2016,2015-11-28 00:00:00,Aston Villa,Watford,2,3,2.75,3.3,2.8,6,9,3,4,6,13,2,4,0,0,19,9,10,10,66.0,34.0,5,15,7,19,6,0,28,20
2791,4440,14,2015/2016,2015-11-28 00:00:00,Bournemouth,Everton,3,3,2.9,3.6,2.5,12,5,5,2,6,6,2,0,0,0,11,5,10,5,58.0,42.0,6,17,7,12,2,0,16,15
2792,4441,14,2015/2016,2015-11-28 00:00:00,Crystal Palace,Newcastle United,5,1,1.7,3.9,5.5,7,3,7,1,7,13,1,1,0,0,18,14,7,5,54.0,46.0,6,10,8,20,2,0,32,12
2793,4442,14,2015/2016,2015-11-28 00:00:00,Leicester City,Manchester United,1,1,3.1,3.5,2.4,3,6,3,4,5,7,0,1,0,0,14,22,1,8,32.0,68.0,2,9,7,12,1,0,36,9
2794,4444,14,2015/2016,2015-11-28 00:00:00,Manchester City,Southampton,3,1,1.6,4.33,6.0,12,5,2,2,14,11,2,1,0,0,8,9,6,4,47.0,53.0,4,17,4,25,3,0,17,10
2795,4446,14,2015/2016,2015-11-28 00:00:00,Sunderland,Stoke City,2,0,3.2,3.3,2.45,7,3,8,3,4,10,0,3,0,0,17,9,9,5,48.0,52.0,2,10,11,14,3,0,26,14
2796,4443,14,2015/2016,2015-11-29 00:00:00,Liverpool,Swansea City,1,0,1.44,4.75,8.0,6,2,3,6,12,7,3,1,0,0,13,17,8,7,57.0,43.0,1,8,9,19,4,0,30,15
2797,4445,14,2015/2016,2015-11-29 00:00:00,Norwich City,Arsenal,1,1,6.0,4.2,1.62,2,3,4,8,8,6,1,1,0,0,18,27,3,6,37.0,63.0,2,5,12,14,2,0,45,9
2798,4447,14,2015/2016,2015-11-29 00:00:00,Tottenham Hotspur,Chelsea,0,0,2.6,3.4,2.9,7,1,3,4,14,9,4,2,0,0,14,14,4,4,56.0,44.0,0,8,7,23,6,0,28,8
2799,4448,14,2015/2016,2015-11-29 00:00:00,West Ham United,West Bromwich Albion,1,1,2.05,3.5,4.0,8,5,8,2,15,16,0,2,0,0,19,19,5,2,61.0,39.0,2,13,10,31,2,0,38,7
2800,4449,15,2015/2016,2015-12-05 00:00:00,Arsenal,Sunderland,3,1,1.29,6.0,13.0,8,5,6,6,7,11,1,1,0,0,13,19,3,2,74.0,26.0,4,13,12,18,2,0,32,5
2801,4450,15,2015/2016,2015-12-05 00:00:00,Chelsea,Bournemouth,0,1,1.36,5.25,9.5,11,7,9,6,10,13,2,1,0,0,30,7,11,4,63.0,37.0,1,18,15,23,3,0,37,15
2802,4452,15,2015/2016,2015-12-05 00:00:00,Manchester United,West Ham United,0,0,1.44,4.5,9.0,7,5,12,6,9,13,1,0,0,0,25,12,6,2,63.0,37.0,0,12,18,22,1,0,37,8
2803,4454,15,2015/2016,2015-12-05 00:00:00,Southampton,Aston Villa,1,1,1.5,4.5,7.5,7,2,13,6,4,9,1,2,0,0,29,2,10,4,61.0,39.0,2,9,19,13,3,0,31,14
2804,4455,15,2015/2016,2015-12-05 00:00:00,Stoke City,Manchester City,2,0,5.25,4.0,1.7,2,4,4,6,9,10,0,1,0,0,6,13,1,6,46.0,54.0,2,6,10,19,1,0,19,7
2805,4456,15,2015/2016,2015-12-05 00:00:00,Swansea City,Leicester City,0,3,2.7,3.4,2.75,3,5,7,7,4,17,2,3,0,0,20,8,3,8,60.0,40.0,3,8,14,21,5,0,28,11
2806,4457,15,2015/2016,2015-12-05 00:00:00,Watford,Norwich City,2,0,2.15,3.5,3.6,8,2,5,4,11,10,3,3,0,0,15,18,4,1,51.0,49.0,2,10,9,21,6,0,33,5
2807,4458,15,2015/2016,2015-12-05 00:00:00,West Bromwich Albion,Tottenham Hotspur,1,1,4.75,3.6,1.85,6,6,4,2,13,10,3,2,0,0,19,11,3,6,35.0,65.0,2,12,6,23,5,0,30,9
2808,4453,15,2015/2016,2015-12-06 00:00:00,Newcastle United,Liverpool,2,0,5.75,4.33,1.62,3,4,4,9,7,10,3,1,0,0,9,14,2,7,41.0,59.0,2,7,13,17,4,0,23,9
2809,4451,15,2015/2016,2015-12-07 00:00:00,Everton,Crystal Palace,1,1,2.1,3.6,3.75,9,6,8,5,4,11,1,2,0,0,25,18,13,6,63.0,37.0,2,15,13,15,3,0,43,19
2810,4460,16,2015/2016,2015-12-12 00:00:00,Bournemouth,Manchester United,2,1,3.4,3.4,2.3,4,6,7,3,12,12,2,1,0,0,12,20,5,7,43.0,57.0,3,10,10,24,3,0,32,12
2811,4461,16,2015/2016,2015-12-12 00:00:00,Crystal Palace,Southampton,1,0,2.6,3.3,3.0,10,7,2,7,11,13,0,0,0,0,17,21,8,5,43.0,57.0,1,17,9,24,0,0,38,13
2812,4464,16,2015/2016,2015-12-12 00:00:00,Manchester City,Swansea City,2,1,1.3,6.0,11.0,5,8,5,3,13,15,3,1,0,0,10,12,5,5,55.0,45.0,3,13,8,28,4,0,22,10
2813,4465,16,2015/2016,2015-12-12 00:00:00,Norwich City,Everton,1,1,2.9,3.5,2.55,1,4,6,11,10,6,1,0,0,0,13,11,5,4,41.0,59.0,2,5,17,16,1,0,24,9
2814,4466,16,2015/2016,2015-12-12 00:00:00,Sunderland,Watford,0,1,2.9,3.3,2.63,2,8,12,3,6,9,1,0,0,0,29,8,8,3,47.0,53.0,1,10,15,15,1,0,37,11
2815,4468,16,2015/2016,2015-12-12 00:00:00,West Ham United,Stoke City,0,0,2.63,3.3,2.9,21,4,6,6,7,9,1,2,0,0,27,15,11,7,46.0,54.0,0,25,12,16,3,0,42,18
2816,4459,16,2015/2016,2015-12-13 00:00:00,Aston Villa,Arsenal,0,2,6.5,4.2,1.57,7,4,11,3,8,7,0,0,0,0,19,13,5,5,46.0,54.0,2,11,14,15,0,0,32,10
2817,4463,16,2015/2016,2015-12-13 00:00:00,Liverpool,West Bromwich Albion,2,2,1.4,4.75,10.0,15,2,11,2,7,10,0,0,0,0,44,11,4,4,70.0,30.0,4,17,13,17,0,0,55,8
2818,4467,16,2015/2016,2015-12-13 00:00:00,Tottenham Hotspur,Newcastle United,1,2,1.36,5.5,9.0,12,3,7,4,13,14,2,2,0,0,13,15,6,2,58.0,42.0,3,15,11,27,4,0,28,8
2819,4462,16,2015/2016,2015-12-14 00:00:00,Leicester City,Chelsea,2,1,3.2,3.5,2.35,4,8,3,3,16,8,2,0,0,0,25,30,1,8,34.0,66.0,3,12,6,24,2,0,55,9
2820,4470,17,2015/2016,2015-12-19 00:00:00,Chelsea,Sunderland,3,1,1.33,5.25,12.0,7,4,6,7,12,12,1,3,0,0,16,10,2,2,68.0,32.0,4,11,13,24,4,0,26,4
2821,4471,17,2015/2016,2015-12-19 00:00:00,Everton,Leicester City,2,3,2.1,3.75,3.6,8,1,5,4,6,13,2,1,0,0,23,7,10,2,68.0,32.0,5,9,9,19,3,0,30,12
2822,4472,17,2015/2016,2015-12-19 00:00:00,Manchester United,Norwich City,1,2,1.45,4.5,8.5,6,2,6,2,4,10,0,2,0,0,46,9,11,0,70.0,30.0,3,8,8,14,2,0,55,11
2823,4473,17,2015/2016,2015-12-19 00:00:00,Newcastle United,Aston Villa,1,1,2.05,3.5,4.0,4,6,5,3,9,14,1,3,0,0,24,28,3,7,47.0,53.0,2,10,8,23,4,0,52,10
2824,4474,17,2015/2016,2015-12-19 00:00:00,Southampton,Tottenham Hotspur,0,2,2.7,3.4,2.8,10,6,1,5,18,9,1,1,0,0,15,13,4,7,51.0,49.0,2,16,6,27,2,0,28,11
2825,4475,17,2015/2016,2015-12-19 00:00:00,Stoke City,Crystal Palace,1,2,2.5,3.2,3.2,11,4,10,7,6,12,2,0,0,0,28,11,7,3,59.0,41.0,3,15,17,18,2,0,39,10
2826,4478,17,2015/2016,2015-12-19 00:00:00,West Bromwich Albion,Bournemouth,1,2,2.55,3.3,3.0,3,7,2,6,12,9,2,1,2,0,19,17,4,8,31.0,69.0,3,10,8,21,3,2,36,12
2827,4476,17,2015/2016,2015-12-20 00:00:00,Swansea City,West Ham United,0,0,2.1,3.4,3.9,10,3,11,7,5,9,0,1,0,0,18,14,8,9,73.0,27.0,0,13,18,14,1,0,32,17
2828,4477,17,2015/2016,2015-12-20 00:00:00,Watford,Liverpool,3,0,4.2,3.6,1.95,3,8,0,6,6,9,1,0,0,0,10,19,7,9,34.0,66.0,3,11,6,15,1,0,29,16
2829,4469,17,2015/2016,2015-12-21 00:00:00,Arsenal,Manchester City,2,1,2.45,3.5,3.0,3,10,3,6,5,16,0,2,0,0,16,28,4,8,37.0,63.0,3,13,9,21,2,0,44,12
2830,4479,18,2015/2016,2015-12-26 00:00:00,Aston Villa,West Ham United,1,1,2.63,3.25,2.75,8,5,6,4,13,12,3,3,0,0,23,7,9,6,59.0,41.0,2,13,10,25,6,0,30,15
2831,4480,18,2015/2016,2015-12-26 00:00:00,Bournemouth,Crystal Palace,0,0,2.4,3.3,3.0,8,4,2,5,10,13,1,0,0,0,14,21,8,9,55.0,45.0,0,12,7,23,1,0,35,17
2832,4481,18,2015/2016,2015-12-26 00:00:00,Chelsea,Watford,2,2,1.44,4.5,7.5,8,8,7,3,7,15,1,4,0,0,22,11,9,4,62.0,38.0,4,16,10,22,5,0,33,13
2833,4482,18,2015/2016,2015-12-26 00:00:00,Liverpool,Leicester City,1,0,1.91,3.8,3.8,13,3,13,5,12,8,2,1,0,0,27,25,7,6,61.0,39.0,1,16,18,20,3,0,52,13
2834,4483,18,2015/2016,2015-12-26 00:00:00,Manchester City,Sunderland,4,1,1.2,7.0,13.0,8,4,4,5,10,11,1,1,0,0,15,16,5,1,66.0,34.0,5,12,9,21,2,0,31,6
2835,4484,18,2015/2016,2015-12-26 00:00:00,Newcastle United,Everton,0,1,3.2,3.5,2.2,3,11,6,6,16,12,2,2,0,0,12,12,3,7,39.0,61.0,1,14,12,28,4,0,24,10
2836,4485,18,2015/2016,2015-12-26 00:00:00,Southampton,Arsenal,4,0,3.6,3.5,2.05,5,5,5,2,10,9,1,0,0,0,13,22,3,4,35.0,65.0,4,10,7,19,1,0,35,7
2837,4486,18,2015/2016,2015-12-26 00:00:00,Stoke City,Manchester United,2,0,3.25,3.2,2.3,4,8,8,2,13,16,1,2,0,0,9,22,1,12,42.0,58.0,2,12,10,29,3,0,31,13
2838,4487,18,2015/2016,2015-12-26 00:00:00,Swansea City,West Bromwich Albion,1,0,1.91,3.4,4.5,1,4,3,5,9,12,1,3,0,0,6,23,0,7,58.0,42.0,1,5,8,21,4,0,29,7
2839,4488,18,2015/2016,2015-12-26 00:00:00,Tottenham Hotspur,Norwich City,3,0,1.4,4.75,8.0,9,4,3,6,4,14,1,2,0,0,11,14,9,4,59.0,41.0,3,13,9,18,3,0,25,13
2840,4489,19,2015/2016,2015-12-28 00:00:00,Arsenal,Bournemouth,2,0,1.44,4.75,8.0,7,7,8,3,7,7,2,0,0,0,23,10,9,3,54.0,46.0,2,14,11,14,2,0,33,12
2841,4490,19,2015/2016,2015-12-28 00:00:00,Crystal Palace,Swansea City,0,0,2.1,3.4,4.0,5,5,8,1,10,17,3,2,0,0,23,9,7,4,54.0,46.0,0,10,9,27,5,0,32,11
2842,4491,19,2015/2016,2015-12-28 00:00:00,Everton,Stoke City,3,4,1.95,3.6,4.2,3,3,9,2,10,12,2,1,0,0,21,8,6,2,51.0,49.0,7,6,11,22,3,0,29,8
2843,4493,19,2015/2016,2015-12-28 00:00:00,Manchester United,Chelsea,0,0,2.6,3.3,3.0,6,3,5,5,16,6,4,2,0,0,23,10,5,3,67.0,33.0,0,9,10,22,6,0,33,8
2844,4494,19,2015/2016,2015-12-28 00:00:00,Norwich City,Aston Villa,2,0,2.05,3.6,3.8,3,4,4,4,10,20,2,5,0,0,10,15,3,7,48.0,52.0,2,7,8,30,7,0,25,10
2845,4496,19,2015/2016,2015-12-28 00:00:00,Watford,Tottenham Hotspur,1,2,3.75,3.5,2.1,5,3,3,5,11,13,4,2,1,0,17,20,5,3,37.0,63.0,3,8,8,24,6,1,37,8
2846,4497,19,2015/2016,2015-12-28 00:00:00,West Bromwich Albion,Newcastle United,1,0,2.2,3.25,3.75,15,4,5,4,7,13,0,0,0,0,24,15,18,6,52.0,48.0,1,19,9,20,0,0,39,24
2847,4498,19,2015/2016,2015-12-28 00:00:00,West Ham United,Southampton,2,1,3.6,3.4,2.2,4,5,7,9,6,12,1,3,0,0,13,28,4,7,53.0,47.0,3,9,16,18,4,0,41,11
2848,4492,19,2015/2016,2015-12-29 00:00:00,Leicester City,Manchester City,0,0,4.33,4.0,1.85,5,12,6,6,11,8,1,3,0,0,23,30,1,13,39.0,61.0,0,17,12,19,4,0,53,14
2849,4495,19,2015/2016,2015-12-30 00:00:00,Sunderland,Liverpool,0,1,5.5,3.9,1.7,3,8,5,9,8,16,1,3,0,0,14,11,6,4,41.0,59.0,1,11,14,24,4,0,25,10
2850,4509,20,2015/2016,2016-01-02 00:00:00,Arsenal,Newcastle United,1,0,1.29,6.5,11.0,4,7,10,5,10,8,2,2,0,0,19,26,7,4,51.0,49.0,1,11,15,18,4,0,45,11
2851,4512,20,2015/2016,2016-01-02 00:00:00,Leicester City,Bournemouth,0,0,1.91,3.75,4.33,6,4,11,5,9,5,1,1,0,1,26,9,7,1,52.0,48.0,0,10,16,14,2,1,35,8
2852,4513,20,2015/2016,2016-01-02 00:00:00,Manchester United,Swansea City,2,1,1.55,4.2,7.0,10,5,6,3,14,10,2,1,0,0,18,11,4,2,56.0,44.0,3,15,9,24,3,0,29,6
2853,4514,20,2015/2016,2016-01-02 00:00:00,Norwich City,Southampton,1,0,3.2,3.4,2.4,3,5,7,5,10,7,1,1,0,0,13,23,4,9,41.0,59.0,1,8,12,17,2,0,36,13
2854,4515,20,2015/2016,2016-01-02 00:00:00,Sunderland,Aston Villa,3,1,2.5,3.25,3.2,5,3,6,5,8,12,3,3,0,0,10,7,3,3,45.0,55.0,4,8,11,20,6,0,17,6
2855,4516,20,2015/2016,2016-01-02 00:00:00,Watford,Manchester City,1,2,5.0,4.0,1.75,3,6,6,9,5,10,1,0,0,0,15,13,4,5,48.0,52.0,3,9,15,15,1,0,28,9
2856,4517,20,2015/2016,2016-01-02 00:00:00,West Bromwich Albion,Stoke City,2,1,2.8,3.2,2.8,6,9,6,0,7,15,1,1,0,1,23,16,4,6,46.0,54.0,3,15,6,22,2,1,39,10
2857,4518,20,2015/2016,2016-01-02 00:00:00,West Ham United,Liverpool,2,0,4.0,3.5,2.05,6,12,7,11,12,8,1,1,0,0,14,27,3,9,35.0,65.0,2,18,18,20,2,0,41,12
2858,4510,20,2015/2016,2016-01-03 00:00:00,Crystal Palace,Chelsea,0,3,3.8,3.5,2.1,5,5,3,4,12,15,3,0,0,0,23,9,5,7,39.0,61.0,3,10,7,27,3,0,32,12
2859,4511,20,2015/2016,2016-01-03 00:00:00,Everton,Tottenham Hotspur,1,1,2.8,3.5,2.63,8,11,4,6,8,11,1,2,0,0,17,24,4,4,40.0,60.0,2,19,10,19,3,0,41,8
2860,4519,21,2015/2016,2016-01-12 00:00:00,Aston Villa,Crystal Palace,1,0,3.2,3.25,2.45,6,2,6,6,16,9,2,1,0,0,15,13,9,0,52.0,48.0,1,8,12,25,3,0,28,9
2861,4520,21,2015/2016,2016-01-12 00:00:00,Bournemouth,West Ham United,1,3,2.0,3.6,4.0,7,3,3,5,8,5,1,1,0,0,7,13,4,7,48.0,52.0,4,10,8,13,2,0,20,11
2862,4525,21,2015/2016,2016-01-12 00:00:00,Newcastle United,Manchester United,3,3,5.0,3.7,1.8,6,3,4,5,10,12,1,3,0,0,21,12,5,3,54.0,46.0,6,9,9,22,4,0,33,8
2863,4521,21,2015/2016,2016-01-13 00:00:00,Swansea City,Sunderland,2,4,1.8,3.6,5.25,6,2,4,4,9,13,0,2,1,0,7,10,8,6,52.0,48.0,6,8,8,22,2,1,17,14
2864,4522,21,2015/2016,2016-01-13 00:00:00,Liverpool,Arsenal,3,3,2.88,3.4,2.6,11,4,9,7,9,7,2,0,0,0,26,4,9,3,59.0,41.0,6,15,16,16,2,0,30,12
2865,4523,21,2015/2016,2016-01-13 00:00:00,Chelsea,West Bromwich Albion,2,2,1.44,4.5,9.0,6,5,9,6,13,8,3,3,0,0,10,21,7,7,62.0,38.0,4,11,15,21,6,0,31,14
2866,4524,21,2015/2016,2016-01-13 00:00:00,Manchester City,Everton,0,0,1.53,4.75,6.0,12,4,10,3,5,6,0,1,0,0,40,10,12,5,55.0,45.0,0,16,13,11,1,0,50,17
2867,4526,21,2015/2016,2016-01-13 00:00:00,Southampton,Watford,2,0,1.95,3.5,4.33,6,4,7,1,9,11,1,2,0,0,24,16,8,1,50.0,50.0,2,10,8,20,3,0,40,9
2868,4527,21,2015/2016,2016-01-13 00:00:00,Stoke City,Norwich City,3,1,2.05,3.3,4.2,5,1,6,3,5,8,0,1,0,1,27,12,7,3,64.0,36.0,4,6,9,13,1,1,39,10
2869,4528,21,2015/2016,2016-01-13 00:00:00,Tottenham Hotspur,Leicester City,0,1,1.75,3.8,5.25,12,5,9,4,13,10,1,0,0,0,25,17,16,8,62.0,38.0,1,17,13,23,1,0,42,24
2870,4529,22,2015/2016,2016-01-16 00:00:00,Aston Villa,Leicester City,1,1,3.6,3.4,2.2,8,6,4,4,13,15,3,2,0,0,30,10,3,4,57.0,43.0,2,14,8,28,5,0,40,7
2871,4530,22,2015/2016,2016-01-16 00:00:00,Bournemouth,Norwich City,3,0,1.91,3.6,4.5,6,7,6,3,8,13,1,1,0,0,12,8,5,3,46.0,54.0,3,13,9,21,2,0,20,8
2872,4531,22,2015/2016,2016-01-16 00:00:00,Chelsea,Everton,3,3,1.83,3.75,4.75,10,5,2,3,12,5,1,1,0,0,31,10,6,4,54.0,46.0,6,15,5,17,2,0,41,10
2873,4533,22,2015/2016,2016-01-16 00:00:00,Manchester City,Crystal Palace,4,0,1.4,5.25,8.5,6,6,8,4,11,10,0,2,0,0,10,19,5,6,51.0,49.0,4,12,12,21,2,0,29,11
2874,4534,22,2015/2016,2016-01-16 00:00:00,Newcastle United,West Ham United,2,1,2.5,3.4,3.0,14,4,9,4,9,4,1,0,0,0,9,19,3,3,49.0,51.0,3,18,13,13,1,0,28,6
2875,4535,22,2015/2016,2016-01-16 00:00:00,Southampton,West Bromwich Albion,3,0,1.73,3.75,5.5,5,2,2,7,10,11,0,0,0,0,16,19,1,3,57.0,43.0,3,7,9,21,0,0,35,4
2876,4538,22,2015/2016,2016-01-16 00:00:00,Tottenham Hotspur,Sunderland,4,1,1.36,5.25,9.5,12,1,9,3,8,13,0,2,0,0,26,10,11,3,68.0,32.0,5,13,12,21,2,0,36,14
2877,4532,22,2015/2016,2016-01-17 00:00:00,Liverpool,Manchester United,0,1,2.3,3.25,3.5,10,1,10,5,6,18,0,2,0,0,16,12,5,4,53.0,47.0,1,11,15,24,2,0,28,9
2878,4536,22,2015/2016,2016-01-17 00:00:00,Stoke City,Arsenal,0,0,4.33,3.6,1.95,8,6,4,3,16,10,0,0,0,0,18,8,6,6,45.0,55.0,0,14,7,26,0,0,26,12
2879,4537,22,2015/2016,2016-01-18 00:00:00,Swansea City,Watford,1,0,2.38,3.25,3.4,3,5,4,8,8,11,2,2,0,0,28,24,6,3,57.0,43.0,1,8,12,19,4,0,52,9
2880,4540,23,2015/2016,2016-01-23 00:00:00,Crystal Palace,Tottenham Hotspur,1,3,3.6,3.5,2.15,5,13,5,6,11,12,2,2,0,0,20,21,3,10,35.0,65.0,4,18,11,23,4,0,41,13
2881,4542,23,2015/2016,2016-01-23 00:00:00,Leicester City,Stoke City,3,0,2.1,3.5,3.8,4,4,8,0,10,13,0,1,0,0,27,20,8,4,45.0,55.0,3,8,8,23,1,0,47,12
2882,4543,23,2015/2016,2016-01-23 00:00:00,Manchester United,Southampton,0,1,1.91,3.5,4.75,3,1,6,5,11,8,0,0,0,0,13,16,4,4,56.0,44.0,1,4,11,19,0,0,29,8
2883,4544,23,2015/2016,2016-01-23 00:00:00,Norwich City,Liverpool,4,5,4.33,3.5,1.95,1,6,2,2,9,14,0,1,0,0,21,16,3,3,48.0,52.0,9,7,4,23,1,0,37,6
2884,4545,23,2015/2016,2016-01-23 00:00:00,Sunderland,Bournemouth,1,1,3.0,3.4,2.5,4,5,1,8,5,9,1,1,0,0,10,13,3,4,41.0,59.0,2,9,9,14,2,0,23,7
2885,4546,23,2015/2016,2016-01-23 00:00:00,Watford,Newcastle United,2,1,2.05,3.5,4.0,4,2,5,7,10,12,2,1,0,0,16,26,2,7,52.0,48.0,3,6,12,22,3,0,42,9
2886,4547,23,2015/2016,2016-01-23 00:00:00,West Bromwich Albion,Aston Villa,0,0,2.1,3.3,4.0,1,8,4,7,7,13,0,1,0,0,17,24,2,6,39.0,61.0,0,9,11,20,1,0,41,8
2887,4548,23,2015/2016,2016-01-23 00:00:00,West Ham United,Manchester City,2,2,5.0,4.0,1.73,2,12,6,5,11,15,2,3,0,0,18,8,5,2,47.0,53.0,4,14,11,26,5,0,26,7
2888,4539,23,2015/2016,2016-01-24 00:00:00,Arsenal,Chelsea,0,1,2.1,3.5,3.9,2,8,4,3,14,13,1,3,1,0,15,10,6,7,46.0,54.0,1,10,7,27,4,1,25,13
2889,4541,23,2015/2016,2016-01-24 00:00:00,Everton,Swansea City,1,2,1.73,3.8,5.5,8,3,10,2,5,12,0,3,0,0,31,6,7,1,60.0,40.0,3,11,12,17,3,0,37,8
2890,4549,24,2015/2016,2016-02-02 00:00:00,Arsenal,Southampton,0,0,1.75,3.75,5.25,15,10,6,3,10,20,2,1,0,0,23,13,13,3,67.0,33.0,0,25,9,30,3,0,36,16
2891,4550,24,2015/2016,2016-02-02 00:00:00,Leicester City,Liverpool,2,0,2.63,3.4,2.88,7,9,4,7,6,7,0,1,0,0,13,23,3,12,63.0,37.0,2,16,11,13,1,0,36,15
2892,4551,24,2015/2016,2016-02-02 00:00:00,Norwich City,Tottenham Hotspur,0,3,4.5,3.75,1.85,3,6,7,8,8,9,2,2,0,0,20,9,6,8,41.0,59.0,3,9,15,17,4,0,29,14
2893,4552,24,2015/2016,2016-02-02 00:00:00,Sunderland,Manchester City,0,1,8.0,4.75,1.45,6,2,5,4,6,15,1,4,0,0,21,5,8,4,49.0,51.0,1,8,9,21,5,0,26,12
2894,4554,24,2015/2016,2016-02-02 00:00:00,West Ham United,Aston Villa,2,0,1.91,3.5,4.75,3,2,18,2,10,9,3,0,0,1,16,11,5,5,68.0,32.0,2,5,20,19,3,1,27,10
2895,4555,24,2015/2016,2016-02-02 00:00:00,Crystal Palace,Bournemouth,1,2,2.45,3.3,3.2,6,5,7,3,11,15,3,4,0,0,25,11,5,3,50.0,50.0,3,11,10,26,7,0,36,8
2896,4556,24,2015/2016,2016-02-02 00:00:00,Manchester United,Stoke City,3,0,1.7,3.75,5.75,6,3,7,7,13,13,2,1,0,0,16,18,2,5,45.0,55.0,3,9,14,26,3,0,34,7
2897,4557,24,2015/2016,2016-02-02 00:00:00,West Bromwich Albion,Swansea City,1,1,2.63,3.1,3.1,7,8,6,7,12,12,0,0,0,0,27,6,7,7,44.0,56.0,2,15,13,24,0,0,33,14
2898,4553,24,2015/2016,2016-02-03 00:00:00,Watford,Chelsea,0,0,4.33,3.5,1.95,7,9,4,4,10,13,2,1,0,0,12,23,7,7,45.0,55.0,0,16,8,23,3,0,35,14
2899,4558,24,2015/2016,2016-02-03 00:00:00,Everton,Newcastle United,3,0,1.65,4.2,5.5,6,4,10,3,7,15,1,2,0,1,7,16,3,3,55.0,45.0,3,10,13,22,3,1,23,6
2900,4559,25,2015/2016,2016-02-06 00:00:00,Aston Villa,Norwich City,2,0,2.45,3.2,3.3,1,8,4,7,9,11,0,2,0,0,15,18,2,11,49.0,51.0,2,9,11,20,2,0,33,13
2901,4562,25,2015/2016,2016-02-06 00:00:00,Liverpool,Sunderland,2,2,1.44,4.75,8.5,6,1,9,4,5,12,1,1,0,0,18,4,7,2,74.0,26.0,4,7,13,17,2,0,22,9
2902,4563,25,2015/2016,2016-02-06 00:00:00,Manchester City,Leicester City,1,3,1.62,4.2,6.0,8,5,12,3,9,15,2,2,0,0,17,18,11,4,65.0,35.0,4,13,15,24,4,0,35,15
2903,4564,25,2015/2016,2016-02-06 00:00:00,Newcastle United,West Bromwich Albion,1,0,2.15,3.4,3.8,11,1,8,5,12,12,0,3,0,0,23,12,8,4,69.0,31.0,1,12,13,24,3,0,35,12
2904,4565,25,2015/2016,2016-02-06 00:00:00,Southampton,West Ham United,1,0,1.73,3.8,5.5,3,11,3,7,17,10,1,2,1,0,12,33,4,5,36.0,64.0,1,14,10,27,3,1,45,9
2905,4566,25,2015/2016,2016-02-06 00:00:00,Stoke City,Everton,0,3,2.7,3.4,2.8,7,6,5,4,12,8,1,0,0,0,25,8,6,4,67.0,33.0,3,13,9,20,1,0,33,10
2906,4567,25,2015/2016,2016-02-06 00:00:00,Swansea City,Crystal Palace,1,1,2.25,3.3,3.6,8,2,8,7,11,14,1,2,0,0,31,16,9,5,58.0,42.0,2,10,15,25,3,0,47,14
2907,4568,25,2015/2016,2016-02-06 00:00:00,Tottenham Hotspur,Watford,1,0,1.5,4.33,8.0,22,2,6,2,12,9,0,1,0,0,26,9,15,1,68.0,32.0,1,24,8,21,1,0,35,16
2908,4560,25,2015/2016,2016-02-07 00:00:00,Bournemouth,Arsenal,0,2,3.8,3.5,2.1,11,6,7,1,5,8,0,1,0,0,22,8,7,3,51.0,49.0,2,17,8,13,1,0,30,10
2909,4561,25,2015/2016,2016-02-07 00:00:00,Chelsea,Manchester United,1,1,2.15,3.3,3.9,10,12,5,5,6,9,0,3,0,0,26,24,10,11,48.0,52.0,2,22,10,15,3,0,50,21
2910,4571,26,2015/2016,2016-02-13 00:00:00,Bournemouth,Stoke City,1,3,2.05,3.4,4.1,5,3,6,3,7,18,4,2,0,0,13,11,9,2,65.0,35.0,4,8,9,25,6,0,24,11
2911,4572,26,2015/2016,2016-02-13 00:00:00,Chelsea,Newcastle United,5,1,1.44,4.75,8.0,8,5,4,3,10,17,0,2,0,0,11,13,8,5,53.0,47.0,6,13,7,27,2,0,24,13
2912,4573,26,2015/2016,2016-02-13 00:00:00,Crystal Palace,Watford,1,2,2.25,3.3,3.6,7,4,7,4,16,12,0,1,1,0,23,12,8,3,52.0,48.0,3,11,11,28,1,1,35,11
2913,4574,26,2015/2016,2016-02-13 00:00:00,Everton,West Bromwich Albion,0,1,1.53,4.2,7.5,17,1,15,3,10,12,1,4,0,0,43,8,14,1,76.0,24.0,1,18,18,22,5,0,51,15
2914,4576,26,2015/2016,2016-02-13 00:00:00,Norwich City,West Ham United,2,2,2.38,3.4,3.25,3,5,8,5,16,11,2,2,0,0,16,18,3,3,48.0,52.0,4,8,13,27,4,0,34,6
2915,4577,26,2015/2016,2016-02-13 00:00:00,Sunderland,Manchester United,2,1,5.25,3.75,1.75,9,8,11,3,7,15,2,3,0,0,10,20,6,8,34.0,66.0,3,17,14,22,5,0,30,14
2916,4578,26,2015/2016,2016-02-13 00:00:00,Swansea City,Southampton,0,1,3.2,3.25,2.5,6,10,7,4,10,12,0,3,0,0,34,19,5,4,55.0,45.0,1,16,11,22,3,0,53,9
2917,4569,26,2015/2016,2016-02-14 00:00:00,Arsenal,Leicester City,2,1,1.75,4.0,5.0,10,3,14,2,10,12,4,4,0,0,39,15,11,1,73.0,27.0,3,13,16,22,8,0,54,12
2918,4570,26,2015/2016,2016-02-14 00:00:00,Aston Villa,Liverpool,0,6,4.75,3.6,1.85,3,3,2,2,10,8,3,1,0,0,15,20,0,6,39.0,61.0,6,6,4,18,4,0,35,6
2919,4575,26,2015/2016,2016-02-14 00:00:00,Manchester City,Tottenham Hotspur,1,2,2.1,3.75,3.6,6,1,8,3,12,17,1,3,0,0,24,15,7,1,44.0,56.0,3,7,11,29,4,0,39,8
2920,4579,27,2015/2016,2016-02-27 00:00:00,Leicester City,Norwich City,1,0,1.5,4.33,6.0,6,2,5,6,9,11,0,2,0,0,23,11,3,4,59.0,41.0,1,8,11,20,2,0,34,7
2921,4583,27,2015/2016,2016-02-27 00:00:00,Southampton,Chelsea,1,2,2.8,3.25,2.5,4,5,5,11,10,11,3,1,0,0,19,22,7,8,34.0,66.0,3,9,16,21,4,0,41,15
2922,4584,27,2015/2016,2016-02-27 00:00:00,Stoke City,Aston Villa,2,1,1.62,3.75,5.5,3,0,5,4,7,15,0,3,0,0,25,16,11,0,56.0,44.0,3,3,9,22,3,0,41,11
2923,4586,27,2015/2016,2016-02-27 00:00:00,Watford,Bournemouth,0,0,2.38,3.25,3.0,6,5,8,6,13,16,3,1,0,0,12,20,4,5,47.0,53.0,0,11,14,29,4,0,32,9
2924,4587,27,2015/2016,2016-02-27 00:00:00,West Bromwich Albion,Crystal Palace,3,2,2.6,3.1,2.8,3,5,4,8,14,16,2,2,0,0,21,28,3,6,47.0,53.0,5,8,12,30,4,0,49,9
2925,4588,27,2015/2016,2016-02-27 00:00:00,West Ham United,Sunderland,1,0,1.8,3.5,4.5,2,6,6,7,11,9,1,0,0,0,17,21,5,6,54.0,46.0,1,8,13,20,1,0,38,11
2926,4581,27,2015/2016,2016-02-28 00:00:00,Manchester United,Arsenal,3,2,3.0,3.25,2.38,3,6,1,3,21,15,4,3,0,0,8,20,2,3,39.0,61.0,5,9,4,36,7,0,28,5
2927,4585,27,2015/2016,2016-02-28 00:00:00,Tottenham Hotspur,Swansea City,2,1,1.4,4.2,9.0,15,6,13,4,11,14,2,3,0,0,23,6,7,7,59.0,41.0,3,21,17,25,5,0,29,14
2928,4590,28,2015/2016,2016-03-01 00:00:00,Aston Villa,Everton,1,3,4.5,3.6,1.91,7,4,8,3,8,7,3,1,0,0,30,10,9,8,46.0,54.0,4,11,11,15,4,0,40,17
2929,4591,28,2015/2016,2016-03-01 00:00:00,Bournemouth,Southampton,2,0,2.9,3.25,2.7,5,2,2,3,11,18,0,0,0,0,15,16,10,2,46.0,54.0,2,7,5,29,0,0,31,12
2930,4592,28,2015/2016,2016-03-01 00:00:00,Leicester City,West Bromwich Albion,2,2,1.73,3.8,5.5,11,0,9,5,10,9,0,2,0,0,36,11,11,3,64.0,36.0,4,11,14,19,2,0,47,14
2931,4593,28,2015/2016,2016-03-01 00:00:00,Norwich City,Chelsea,1,2,5.25,4.0,1.7,3,5,9,4,17,5,3,2,0,0,27,14,4,4,45.0,55.0,3,8,13,22,5,0,41,8
2932,4594,28,2015/2016,2016-03-01 00:00:00,Sunderland,Crystal Palace,2,2,2.5,3.3,3.1,8,7,8,6,11,14,1,1,0,0,21,15,4,5,58.0,42.0,4,15,14,25,2,0,36,9
2933,4589,28,2015/2016,2016-03-02 00:00:00,Arsenal,Swansea City,1,2,1.36,5.25,10.0,9,2,9,4,8,11,0,2,0,0,22,12,7,3,62.0,38.0,3,11,13,19,2,0,34,10
2934,4595,28,2015/2016,2016-03-02 00:00:00,West Ham United,Tottenham Hotspur,1,0,4.0,3.6,2.0,7,3,6,6,10,11,0,3,0,0,14,13,6,3,34.0,66.0,1,10,12,21,3,0,27,9
2935,4596,28,2015/2016,2016-03-02 00:00:00,Liverpool,Manchester City,3,0,2.63,3.4,2.88,5,2,3,2,14,14,0,1,0,0,8,12,3,2,51.0,49.0,3,7,5,28,1,0,20,5
2936,4597,28,2015/2016,2016-03-02 00:00:00,Manchester United,Watford,1,0,1.67,3.8,6.0,7,5,5,9,7,17,1,2,0,0,18,16,9,7,62.0,38.0,1,12,14,24,3,0,34,16
2937,4598,28,2015/2016,2016-03-02 00:00:00,Stoke City,Newcastle United,1,0,2.0,3.5,4.2,2,4,6,1,11,6,1,0,0,0,19,19,5,2,55.0,45.0,1,6,7,17,1,0,38,7
2938,4599,29,2015/2016,2016-03-05 00:00:00,Chelsea,Stoke City,1,1,1.5,4.5,7.5,11,9,8,6,9,9,1,2,0,0,14,17,8,4,47.0,53.0,2,20,14,18,3,0,31,12
2939,4601,29,2015/2016,2016-03-05 00:00:00,Everton,West Ham United,2,3,1.73,4.0,5.0,10,9,0,7,12,11,3,3,0,0,11,24,9,6,41.0,59.0,5,19,7,23,6,0,35,15
2940,4602,29,2015/2016,2016-03-05 00:00:00,Manchester City,Aston Villa,4,0,1.22,7.0,15.0,7,2,9,0,10,10,0,1,0,0,20,6,9,1,73.0,27.0,4,9,9,20,1,0,26,10
2941,4603,29,2015/2016,2016-03-05 00:00:00,Newcastle United,Bournemouth,1,3,2.63,3.4,2.88,7,10,7,4,13,8,1,3,0,0,16,12,5,4,48.0,52.0,4,17,11,21,4,0,28,9
2942,4604,29,2015/2016,2016-03-05 00:00:00,Southampton,Sunderland,1,1,1.6,4.0,6.5,9,3,4,6,9,9,2,1,1,0,18,14,12,2,65.0,35.0,2,12,10,18,3,1,32,14
2943,4605,29,2015/2016,2016-03-05 00:00:00,Swansea City,Norwich City,1,0,2.05,3.5,4.0,5,6,6,4,14,15,2,5,0,0,10,12,5,0,56.0,44.0,1,11,10,29,7,0,22,5
2944,4606,29,2015/2016,2016-03-05 00:00:00,Tottenham Hotspur,Arsenal,2,2,2.38,3.4,3.25,13,5,9,2,10,10,2,3,0,0,17,5,9,2,52.0,48.0,4,18,11,20,5,0,22,11
2945,4607,29,2015/2016,2016-03-05 00:00:00,Watford,Leicester City,0,1,3.0,3.4,2.55,7,6,5,7,10,11,2,2,0,0,24,13,3,8,50.0,50.0,1,13,12,21,4,0,37,11
2946,4600,29,2015/2016,2016-03-06 00:00:00,Crystal Palace,Liverpool,1,2,3.8,3.5,2.1,8,8,4,5,12,17,1,3,0,0,20,14,6,6,39.0,61.0,3,16,9,29,4,0,34,12
2947,4608,29,2015/2016,2016-03-06 00:00:00,West Bromwich Albion,Manchester United,1,0,4.33,3.4,2.0,7,5,6,3,8,8,1,1,0,0,17,15,4,5,47.0,53.0,1,12,9,16,2,0,32,9
2948,4621,30,2015/2016,2016-03-12 00:00:00,Bournemouth,Swansea City,3,2,1.95,3.5,4.33,5,3,4,7,12,11,1,0,0,0,9,14,5,3,44.0,56.0,5,8,11,23,1,0,23,8
2949,4625,30,2015/2016,2016-03-12 00:00:00,Norwich City,Manchester City,0,0,6.0,4.2,1.6,0,11,4,6,15,10,3,1,0,0,15,22,3,8,34.0,66.0,0,11,10,25,4,0,37,11
2950,4626,30,2015/2016,2016-03-12 00:00:00,Stoke City,Southampton,1,2,2.7,3.2,2.9,5,5,7,7,13,12,1,2,0,1,28,19,1,4,61.0,39.0,3,10,14,25,3,1,47,5
2951,4620,30,2015/2016,2016-03-13 00:00:00,Aston Villa,Tottenham Hotspur,0,2,7.5,4.5,1.5,6,8,6,9,7,6,0,0,0,0,21,8,5,8,37.0,63.0,2,14,15,13,0,0,29,13
2952,4622,30,2015/2016,2016-03-14 00:00:00,Leicester City,Newcastle United,1,0,1.57,4.33,6.25,3,4,6,8,4,9,0,0,0,0,19,17,8,4,49.0,51.0,1,7,14,13,0,0,36,12
2953,4629,31,2015/2016,2016-03-19 00:00:00,Chelsea,West Ham United,2,2,1.75,3.8,5.25,6,5,15,6,13,14,3,5,0,0,29,7,10,9,57.0,43.0,4,11,21,27,8,0,36,19
2954,4630,31,2015/2016,2016-03-19 00:00:00,Crystal Palace,Leicester City,0,1,3.0,3.4,2.5,8,4,6,4,9,13,1,1,0,0,22,16,10,7,56.0,44.0,1,12,10,22,2,0,38,17
2955,4631,31,2015/2016,2016-03-19 00:00:00,Everton,Arsenal,0,2,2.7,3.5,2.7,5,4,3,6,6,10,0,0,0,0,28,7,7,5,55.0,45.0,2,9,9,16,0,0,35,12
2956,4635,31,2015/2016,2016-03-19 00:00:00,Swansea City,Aston Villa,1,0,1.67,3.8,6.0,3,7,5,4,9,10,3,2,0,0,11,36,4,6,53.0,47.0,1,10,9,19,5,0,47,10
2957,4637,31,2015/2016,2016-03-19 00:00:00,Watford,Stoke City,1,2,2.4,3.25,3.3,3,5,4,1,9,13,3,1,0,0,22,11,9,2,52.0,48.0,3,8,5,22,4,0,33,11
2958,4638,31,2015/2016,2016-03-19 00:00:00,West Bromwich Albion,Norwich City,0,1,2.25,3.3,3.6,4,3,4,4,9,15,1,2,0,0,11,15,4,3,51.0,49.0,1,7,8,24,3,0,26,7
2959,4632,31,2015/2016,2016-03-20 00:00:00,Manchester City,Manchester United,0,1,1.83,3.75,4.75,6,4,15,0,9,12,1,1,0,0,20,9,11,5,55.0,45.0,1,10,15,21,2,0,29,16
2960,4633,31,2015/2016,2016-03-20 00:00:00,Newcastle United,Sunderland,1,1,2.1,3.5,3.8,9,5,5,6,14,6,4,1,0,0,20,11,2,5,48.0,52.0,2,14,11,20,5,0,31,7
2961,4634,31,2015/2016,2016-03-20 00:00:00,Southampton,Liverpool,3,2,2.63,3.4,2.88,4,12,10,3,10,13,1,3,0,0,18,10,3,5,50.0,50.0,5,16,13,23,4,0,28,8
2962,4636,31,2015/2016,2016-03-20 00:00:00,Tottenham Hotspur,Bournemouth,3,0,1.53,4.33,7.0,6,0,8,2,11,6,0,1,0,0,6,12,4,5,61.0,39.0,3,6,10,17,1,0,18,9
2963,4639,32,2015/2016,2016-04-02 00:00:00,Arsenal,Watford,4,0,1.36,5.25,10.0,10,3,4,4,7,10,1,1,0,0,15,17,8,3,64.0,36.0,4,13,8,17,2,0,32,11
2964,4640,32,2015/2016,2016-04-02 00:00:00,Aston Villa,Chelsea,0,4,6.5,4.33,1.57,9,4,6,3,12,8,5,1,0,0,11,10,7,2,43.0,57.0,4,13,9,20,6,0,21,9
2965,4641,32,2015/2016,2016-04-02 00:00:00,Bournemouth,Manchester City,0,4,3.75,3.6,2.1,5,4,6,7,9,8,0,1,0,0,19,10,4,4,45.0,55.0,4,9,13,17,1,0,29,8
2966,4643,32,2015/2016,2016-04-02 00:00:00,Liverpool,Tottenham Hotspur,1,1,2.5,3.4,3.0,10,7,3,8,11,11,2,0,0,0,14,15,12,9,43.0,57.0,2,17,11,22,2,0,29,21
2967,4645,32,2015/2016,2016-04-02 00:00:00,Norwich City,Newcastle United,3,2,2.2,3.4,3.6,3,6,6,6,6,11,0,0,0,0,20,22,6,5,43.0,57.0,5,9,12,17,0,0,42,11
2968,4646,32,2015/2016,2016-04-02 00:00:00,Stoke City,Swansea City,2,2,2.2,3.4,3.6,4,5,6,5,6,16,0,1,0,0,12,13,5,5,47.0,53.0,4,9,11,22,1,0,25,10
2969,4647,32,2015/2016,2016-04-02 00:00:00,Sunderland,West Bromwich Albion,0,0,2.1,3.3,4.0,9,1,8,1,11,13,1,1,0,0,13,10,9,3,56.0,44.0,0,10,9,24,2,0,23,12
2970,4648,32,2015/2016,2016-04-02 00:00:00,West Ham United,Crystal Palace,2,2,1.95,3.6,4.2,8,4,3,4,12,19,2,2,1,0,11,22,4,5,67.0,33.0,4,12,7,31,4,1,33,9
2971,4642,32,2015/2016,2016-04-03 00:00:00,Leicester City,Southampton,1,0,2.25,3.4,3.5,6,4,3,5,13,13,2,2,0,0,21,36,7,8,47.0,53.0,1,10,8,26,4,0,57,15
2972,4644,32,2015/2016,2016-04-03 00:00:00,Manchester United,Everton,1,0,2.1,3.5,3.75,5,7,3,2,13,5,2,0,0,0,14,15,5,5,48.0,52.0,1,12,5,18,2,0,29,10
2973,4649,33,2015/2016,2016-04-09 00:00:00,Aston Villa,Bournemouth,1,2,3.4,3.2,2.2,0,4,6,5,13,11,2,2,0,0,14,13,3,8,41.0,59.0,3,4,11,24,4,0,27,11
2974,4650,33,2015/2016,2016-04-09 00:00:00,Crystal Palace,Norwich City,1,0,2.05,3.4,3.6,5,6,2,6,12,9,2,1,0,0,22,16,10,4,50.0,50.0,1,11,8,21,3,0,38,14
2975,4652,33,2015/2016,2016-04-09 00:00:00,Manchester City,West Bromwich Albion,2,1,1.33,5.0,9.0,5,3,6,5,10,7,0,1,0,0,10,25,8,8,61.0,39.0,3,8,11,17,1,0,35,16
2976,4653,33,2015/2016,2016-04-09 00:00:00,Southampton,Newcastle United,3,1,1.53,4.0,6.0,7,3,11,3,8,7,0,0,0,0,22,19,11,2,51.0,49.0,4,10,14,15,0,0,41,13
2977,4655,33,2015/2016,2016-04-09 00:00:00,Swansea City,Chelsea,1,0,3.75,3.4,2.0,8,5,2,8,15,13,5,4,0,0,13,24,1,9,40.0,60.0,1,13,10,28,9,0,37,10
2978,4657,33,2015/2016,2016-04-09 00:00:00,Watford,Everton,1,1,3.4,3.3,2.15,6,7,5,4,13,10,2,1,0,0,13,22,7,6,40.0,60.0,2,13,9,23,3,0,35,13
2979,4658,33,2015/2016,2016-04-09 00:00:00,West Ham United,Arsenal,3,3,3.6,3.5,2.0,11,4,6,2,11,8,2,0,0,0,24,19,7,4,38.0,62.0,6,15,8,19,2,0,43,11
2980,4651,33,2015/2016,2016-04-10 00:00:00,Liverpool,Stoke City,4,1,1.55,4.0,5.75,5,2,6,8,16,16,0,2,0,0,16,18,6,3,53.0,47.0,5,7,14,32,2,0,34,9
2981,4654,33,2015/2016,2016-04-10 00:00:00,Sunderland,Leicester City,0,2,3.4,3.4,2.1,5,8,11,6,12,10,1,1,0,0,11,16,1,7,51.0,49.0,2,13,17,22,2,0,27,8
2982,4656,33,2015/2016,2016-04-10 00:00:00,Tottenham Hotspur,Manchester United,3,0,1.91,3.5,4.0,7,2,6,4,9,10,3,3,0,0,14,15,2,7,45.0,55.0,3,9,10,19,6,0,29,9
2983,4671,35,2015/2016,2016-04-13 00:00:00,Crystal Palace,Everton,0,0,2.9,3.4,2.6,10,7,11,2,7,11,0,2,0,0,28,8,10,7,57.0,43.0,0,17,13,18,2,0,36,17
2984,4661,34,2015/2016,2016-04-16 00:00:00,Chelsea,Manchester City,0,3,2.75,3.4,2.7,7,6,6,2,12,15,2,3,1,0,15,5,11,3,51.0,49.0,3,13,8,27,5,1,20,14
2985,4662,34,2015/2016,2016-04-16 00:00:00,Everton,Southampton,1,1,2.7,3.4,2.8,4,5,3,9,8,15,1,1,0,0,5,22,3,10,49.0,51.0,2,9,12,23,2,0,27,13
2986,4664,34,2015/2016,2016-04-16 00:00:00,Manchester United,Aston Villa,1,0,1.22,7.0,17.0,4,2,7,5,9,10,0,1,0,0,27,11,14,3,65.0,35.0,1,6,12,19,1,0,38,17
2987,4665,34,2015/2016,2016-04-16 00:00:00,Newcastle United,Swansea City,3,0,2.3,3.4,3.4,4,4,5,8,13,9,2,1,0,0,5,12,3,7,34.0,66.0,3,8,13,22,3,0,17,10
2988,4666,34,2015/2016,2016-04-16 00:00:00,Norwich City,Sunderland,0,3,2.4,3.3,3.25,10,0,7,5,7,11,2,2,0,0,24,8,14,0,58.0,42.0,3,10,12,18,4,0,32,14
2989,4668,34,2015/2016,2016-04-16 00:00:00,West Bromwich Albion,Watford,0,1,2.4,3.2,3.4,6,5,8,4,10,17,0,3,0,0,25,5,9,3,63.0,37.0,1,11,12,27,3,0,30,12
2990,4659,34,2015/2016,2016-04-17 00:00:00,Arsenal,Crystal Palace,1,1,1.33,5.75,9.5,9,2,9,3,7,15,0,2,0,0,32,15,10,5,65.0,35.0,2,11,12,22,2,0,47,15
2991,4660,34,2015/2016,2016-04-17 00:00:00,Bournemouth,Liverpool,1,2,3.6,3.5,2.15,11,9,4,9,9,9,0,0,0,0,19,10,5,4,51.0,49.0,3,20,13,18,0,0,29,9
2992,4663,34,2015/2016,2016-04-17 00:00:00,Leicester City,West Ham United,2,2,1.95,3.6,4.2,0,4,4,11,14,14,2,3,0,0,13,29,0,5,43.0,57.0,4,4,15,28,5,0,42,5
2993,4667,34,2015/2016,2016-04-18 00:00:00,Stoke City,Tottenham Hotspur,0,4,4.5,3.75,1.85,3,5,9,12,12,12,2,0,0,0,22,15,5,3,52.0,48.0,4,8,21,24,2,0,37,8
2994,4582,27,2015/2016,2016-04-19 00:00:00,Newcastle United,Manchester City,1,1,6.0,4.5,1.57,2,5,2,3,13,8,3,2,0,0,21,18,5,3,43.0,57.0,2,7,5,21,5,0,39,8
2995,4580,27,2015/2016,2016-04-20 00:00:00,Liverpool,Everton,4,0,1.73,4.0,5.0,21,1,12,2,9,12,1,1,0,1,25,3,9,1,67.0,33.0,4,22,14,21,2,1,28,10
2996,4624,30,2015/2016,2016-04-20 00:00:00,Manchester United,Crystal Palace,2,0,1.53,4.33,7.0,12,4,3,1,13,7,1,2,0,0,26,14,10,2,60.0,40.0,2,16,4,20,3,0,40,12
2997,4628,30,2015/2016,2016-04-20 00:00:00,West Ham United,Watford,3,1,1.57,4.33,6.5,7,3,7,2,11,17,0,3,0,0,14,9,4,2,54.0,46.0,4,10,9,28,3,0,23,6
2998,4619,30,2015/2016,2016-04-21 00:00:00,Arsenal,West Bromwich Albion,2,0,1.29,6.0,13.0,7,2,8,6,14,14,0,1,0,0,16,17,2,6,71.0,29.0,2,9,14,28,1,0,33,8
2999,4669,35,2015/2016,2016-04-23 00:00:00,Aston Villa,Southampton,2,4,7.5,4.2,1.53,9,6,6,8,9,9,2,0,0,0,15,16,6,11,42.0,58.0,6,15,14,18,2,0,31,17
3000,4670,35,2015/2016,2016-04-23 00:00:00,Bournemouth,Chelsea,1,4,3.1,3.5,2.4,5,4,6,8,11,4,1,0,0,0,22,10,10,7,45.0,55.0,5,9,14,15,1,0,32,17
3001,4673,35,2015/2016,2016-04-23 00:00:00,Liverpool,Newcastle United,2,2,1.57,4.5,6.0,7,1,3,3,8,17,1,1,0,0,24,14,5,4,67.0,33.0,4,8,6,25,2,0,38,9
3002,4674,35,2015/2016,2016-04-23 00:00:00,Manchester City,Stoke City,4,0,1.3,6.0,11.0,4,3,3,10,8,9,0,0,0,0,6,11,9,4,53.0,47.0,4,7,13,17,0,0,17,13
3003,4672,35,2015/2016,2016-04-24 00:00:00,Leicester City,Swansea City,4,0,1.75,3.7,5.5,8,5,6,3,14,10,1,2,0,0,10,22,4,6,40.0,60.0,4,13,9,24,3,0,32,10
3004,4676,35,2015/2016,2016-04-24 00:00:00,Sunderland,Arsenal,0,0,4.5,4.0,1.8,5,14,6,6,10,9,2,4,0,0,20,22,7,7,30.0,70.0,0,19,12,19,6,0,42,14
3005,4677,35,2015/2016,2016-04-25 00:00:00,Tottenham Hotspur,West Bromwich Albion,1,1,1.22,7.0,15.0,7,6,12,8,8,13,0,1,0,0,17,20,9,7,66.0,34.0,2,13,20,21,1,0,37,16
3006,4679,36,2015/2016,2016-04-30 00:00:00,Arsenal,Norwich City,1,0,1.29,6.5,11.0,7,6,6,6,8,7,1,0,0,0,13,18,7,3,69.0,31.0,1,13,12,15,1,0,31,10
3007,4681,36,2015/2016,2016-04-30 00:00:00,Everton,Bournemouth,2,1,2.0,3.8,3.8,4,6,3,9,4,8,1,0,0,0,12,15,3,5,56.0,44.0,3,10,12,12,1,0,27,8
3008,4683,36,2015/2016,2016-04-30 00:00:00,Newcastle United,Crystal Palace,1,0,2.0,3.6,4.0,6,4,2,3,11,12,2,0,0,0,14,19,4,8,50.0,50.0,1,10,5,23,2,0,33,12
3009,4685,36,2015/2016,2016-04-30 00:00:00,Stoke City,Sunderland,1,1,2.75,3.3,2.8,4,6,7,5,13,12,2,2,0,0,14,15,2,8,53.0,47.0,2,10,12,25,4,0,29,10
3010,4687,36,2015/2016,2016-04-30 00:00:00,Watford,Aston Villa,3,2,1.7,3.8,5.75,8,1,8,5,14,10,2,3,0,1,30,13,8,4,65.0,35.0,5,9,13,24,5,1,43,12
3011,4688,36,2015/2016,2016-04-30 00:00:00,West Bromwich Albion,West Ham United,0,3,4.0,3.4,2.1,7,1,7,3,14,7,0,0,0,0,12,10,8,6,46.0,54.0,3,8,10,21,0,0,22,14
3012,4682,36,2015/2016,2016-05-01 00:00:00,Manchester United,Leicester City,1,1,2.1,3.4,3.9,17,4,6,11,16,10,3,1,0,0,38,16,6,5,67.0,33.0,2,21,17,26,4,0,54,11
3013,4684,36,2015/2016,2016-05-01 00:00:00,Southampton,Manchester City,4,2,2.8,3.4,2.7,4,4,6,1,12,9,2,1,0,0,16,13,8,2,43.0,57.0,6,8,7,21,3,0,29,10
3014,4686,36,2015/2016,2016-05-01 00:00:00,Swansea City,Liverpool,3,1,3.1,3.5,2.4,9,5,6,5,12,13,2,3,0,0,12,8,4,7,47.0,53.0,4,14,11,25,5,0,20,11
3015,4680,36,2015/2016,2016-05-02 00:00:00,Chelsea,Tottenham Hotspur,2,2,2.75,3.6,2.63,5,6,7,8,9,21,3,9,0,0,15,14,7,8,47.0,53.0,4,11,15,30,12,0,29,15
3016,4689,37,2015/2016,2016-05-07 00:00:00,Aston Villa,Newcastle United,0,0,5.75,4.2,1.65,0,7,2,4,8,13,1,1,0,0,11,26,0,5,47.0,53.0,0,7,6,21,2,0,37,5
3017,4690,37,2015/2016,2016-05-07 00:00:00,Bournemouth,West Bromwich Albion,1,1,1.95,3.6,4.2,6,4,4,5,5,8,2,1,0,0,16,9,5,3,59.0,41.0,2,10,9,13,3,0,25,8
3018,4691,37,2015/2016,2016-05-07 00:00:00,Crystal Palace,Stoke City,2,1,2.05,3.5,3.9,6,3,6,8,8,18,2,3,0,0,16,10,4,3,57.0,43.0,3,9,14,26,5,0,26,7
3019,4692,37,2015/2016,2016-05-07 00:00:00,Leicester City,Everton,3,1,1.91,4.0,4.0,15,4,11,2,4,11,0,3,0,0,28,19,12,4,47.0,53.0,4,19,13,15,3,0,47,16
3020,4695,37,2015/2016,2016-05-07 00:00:00,Norwich City,Manchester United,0,1,4.5,3.6,1.91,6,8,4,8,11,10,1,0,0,0,18,16,1,6,33.0,67.0,1,14,12,21,1,0,34,7
3021,4696,37,2015/2016,2016-05-07 00:00:00,Sunderland,Chelsea,3,2,3.0,3.5,2.45,7,7,4,0,11,9,4,2,0,0,21,18,3,3,31.0,69.0,5,14,4,20,6,0,39,6
3022,4698,37,2015/2016,2016-05-07 00:00:00,West Ham United,Swansea City,1,4,1.44,4.75,8.0,12,6,12,5,11,8,3,0,0,0,26,15,13,3,52.0,48.0,5,18,17,19,3,0,41,16
3023,4693,37,2015/2016,2016-05-08 00:00:00,Liverpool,Watford,2,0,1.5,4.5,7.5,9,3,7,10,10,15,1,2,0,0,17,20,8,8,66.0,34.0,2,12,17,25,3,0,37,16
3024,4694,37,2015/2016,2016-05-08 00:00:00,Manchester City,Arsenal,2,2,2.5,3.6,2.9,2,1,10,2,16,10,2,1,0,0,18,12,7,2,61.0,39.0,4,3,12,26,3,0,30,9
3025,4697,37,2015/2016,2016-05-08 00:00:00,Tottenham Hotspur,Southampton,1,2,2.05,3.6,3.9,9,3,11,5,8,16,0,3,0,0,19,7,10,2,70.0,30.0,3,12,16,24,3,0,26,12
3026,4678,35,2015/2016,2016-05-10 00:00:00,West Ham United,Manchester United,3,2,3.0,3.5,2.45,6,1,13,1,6,19,1,3,0,0,24,13,6,2,47.0,53.0,5,7,14,25,4,0,37,8
3027,4623,30,2015/2016,2016-05-11 00:00:00,Liverpool,Chelsea,1,1,2.0,3.8,3.8,17,9,10,3,11,12,3,1,0,0,10,6,7,3,55.0,45.0,2,26,13,23,4,0,16,10
3028,4627,30,2015/2016,2016-05-11 00:00:00,Sunderland,Everton,3,0,1.75,4.0,5.0,8,9,3,8,15,7,1,0,0,0,14,16,5,5,38.0,62.0,3,17,11,22,1,0,30,10
3029,4675,35,2015/2016,2016-05-11 00:00:00,Norwich City,Watford,4,2,1.83,3.75,4.75,9,8,6,2,8,11,2,3,0,0,23,12,5,1,56.0,44.0,6,17,8,19,5,0,35,6
3030,4699,38,2015/2016,2016-05-15 00:00:00,Arsenal,Aston Villa,4,0,1.17,9.0,17.0,7,4,8,0,10,6,0,1,0,0,16,6,5,4,60.0,40.0,4,11,8,16,1,0,22,9
3031,4700,38,2015/2016,2016-05-15 00:00:00,Chelsea,Leicester City,1,1,2.3,3.75,3.1,11,10,6,8,5,12,0,0,0,0,19,20,7,6,54.0,46.0,2,21,14,17,0,0,39,13
3032,4701,38,2015/2016,2016-05-15 00:00:00,Everton,Norwich City,3,0,1.8,4.0,4.5,9,4,4,5,6,10,0,0,0,0,17,17,4,11,47.0,53.0,3,13,9,16,0,0,34,15
3033,4703,38,2015/2016,2016-05-15 00:00:00,Newcastle United,Tottenham Hotspur,5,1,4.5,4.0,1.8,11,8,4,8,7,6,1,2,1,0,12,14,3,8,39.0,61.0,6,19,12,13,3,1,26,11
3034,4704,38,2015/2016,2016-05-15 00:00:00,Southampton,Crystal Palace,4,1,1.36,5.5,9.0,4,5,13,3,6,14,1,2,0,0,20,15,2,5,49.0,51.0,5,9,16,20,3,0,35,7
3035,4705,38,2015/2016,2016-05-15 00:00:00,Stoke City,West Ham United,2,1,3.5,3.6,2.15,3,10,2,7,8,12,3,1,0,0,13,18,4,10,45.0,55.0,3,13,9,20,4,0,31,14
3036,4706,38,2015/2016,2016-05-15 00:00:00,Swansea City,Manchester City,1,1,6.0,4.75,1.53,1,5,2,12,5,19,1,3,0,0,14,15,4,4,50.0,50.0,2,6,14,24,4,0,29,8
3037,4707,38,2015/2016,2016-05-15 00:00:00,Watford,Sunderland,2,2,2.05,3.75,3.7,6,2,10,2,10,9,1,0,0,0,9,12,7,4,49.0,51.0,4,8,12,19,1,0,21,11
3038,4708,38,2015/2016,2016-05-15 00:00:00,West Bromwich Albion,Liverpool,1,1,2.4,3.6,3.0,5,3,8,3,12,13,3,1,0,0,12,14,7,5,33.0,67.0,2,8,11,25,4,0,26,12
3039,4702,38,2015/2016,2016-05-17 00:00:00,Manchester United,Bournemouth,3,1,1.67,4.2,5.25,5,5,4,2,9,8,1,0,0,0,16,5,7,1,68.0,32.0,4,10,6,17,1,0,21,8
